30 100
GTCCGTTTTGGGACGCAGAGAGTCTAAGGT|ACGCGTGCAGGCACGGAAGATCGCGAAACA
GACTTAGCGAGTCTTCTGTTTTGGGACGCA|AGAGAGTCTAAGGTCTTGCAAGTAGTGTCC
GGCTCCGTCCGTTTTGGGACGCAGAGAGTC|TCAAGCACGCGTGCAGGCACGGAAGATCGC
GGTCTTGCGCAGAGAGTCTGTTTTGGGACG|AAGGCGCCCTATACTAGGAAGGTTTTGGGA
CTAAGGTCTTGAAGGTCGTTTTGGGACGCA|GTCTAAGGTCTTGGGACAGAGAATGATATT
AACTCTAGCGAGACTGCTGCGCCAATGGAG|TTGCTGGCGGTAGCTGGAACGTCAAAGGGT
CTTCTCTAAGATGGGGCAAGCGACTTAGCG|CTGCGTTGGGTTTTGGGACGCAGAGAGTCT
TTTTGGGACGCAGAGAGTCTAAGGTCTTGT|GAGAATGATATTGGGCCTATACGCGGGCTT
AGAGTCTGTTTTGGGACGCAGAGAGTCTAA|ACTAGGAAGGTTTTGGGACGCAGAGAGTCT
GCGCTTTTAGCTCCTGCGTTGGGTTTTGGG|GTTTTGGGACGCAGAGAGTCTAAGGTCTTG
GGAAGATCGCGAAACAAAAGCATTGCACGT|GTGCAGTGGTTCCAAGTATCACGGGCTCAG
GCTTCAGTTGCTGGCGGTAGCTGGAACGTC|TCTTCTGTTTTGGGACGCAGAGAGTCTAAG
AGAGAGTCTAAGGTCTTGGGACAGAGAATG|AGTCTAAGGTCTTGGAACTTCTCTAAGATG
CGCCCTATACTAGGAAGGTTTTGGGACGCA|TTTGGGACGCAGAGAGTCTAAGGTCTTGGA
GTCTAAGGTCTTGTGTTTTGGGACGCAGAG|TGATACACAAACGTTTTGGGACGCAGAGAG
AGCCAAAAGAGCGCAAAACCCTGGTCATCA|GATGCGAACCAAAGGGGACTAGGCTCCGTC
AGTCTATACAAGTTTTGGGACGCAGAGAGT|GTTTTGGGACGCAGAGAGTCTAAGGTCTTG
CCCAGAAGATTAAGACAAATCAAGGACGCG|CAAAAGAGCGCAAAACCCTGGTCATCAAAG
CTACGTTTTGGGACGCAGAGAGTCTAAGGT|TAGCTGGCCTGCAATTGAGGACTGCTAGTA
GCACAAGTGTGTTTTGGGACGCAGAGAGTC|TTGACGAAACACCTAAATTCCCAGACTCAG
GATCGCGAAACAAAAGCATTGCACGTTCTC|AGTGGTTCCAAGTATCACGGGCTCAGGGGC
AGGCCACGCGGTTATTCTCCAACGCCCCAG|CTAAGGTCTTGAAGGTCGTTTTGGGACGCA
ACTAAGAGGAATGTAACAACGGTTCTGTTG|TTTGGGAGTTTTGGGACGCAGAGAGTCTAA
CCACAAAGAGCCCCTCGGCAAAGCACTGGT|GAGTCTAAGGTCTTGTTGAAACTCTAGCGA
CGAGTCTTCTGTTTTGGGACGCAGAGAGTC|CTAAGGTCTTGCAAGTAGTGTCCGAACGTC
GCTACGTTTTGGGACGCAGAGAGTCTAAGG|ATAGCTGGCCTGCAATTGAGGACTGCTAGT
AGTCTAAGGTCTTGGAGTCTAAGGTCTTGG|CAAGGACGCGTTTAAAGGCGCGCTTTTAGC
GAAACTCTAGCGAGACTGCTGCGCCAATGG|AGTTGCTGGCGGTAGCTGGAACGTCAAAGG
AGCCCCTCGGCAAAGCACTGGTTTTGGGAG|GGTCTTGTTGAAACTCTAGCGAGACTGCTG
CTGCACAAGTGTGTTTTGGGACGCAGAGAG|ACTTGACGAAACACCTAAATTCCCAGACTC
AGGTCTTGTCCCATTTGTCCCAGAAGATTA|ATATACAACAAAGCGAGCCAAAAGAGCGCA
ACTGGTTTTGGGAGTTTTGGGACGCAGAGA|TAGCGAGACTGCTGCGCCAATGGAGGCCTA
TGGGACGCAGAGAGTCTAAGGTCTTGCAAG|CTTGTGTTTTGGGACGCAGAGAGTCTAAGG
GGTCTTGGGACAGAGAATGATATTGGGCCT|TTGGAACTTCTCTAAGATGGGGCAAGCGAC
TGAAGGTCGTTTTGGGACGCAGAGAGTCTA|CTTGGGACAGAGAATGATATTGGGCCTATA
ACTTCGCAACCTAGTCAGCCTGCAAACTAC|GCGCAGAGAGTCTGTTTTGGGACGCAGAGA
TTTGGGACGCAGAGAGTCTAAGGTCTTGAA|GTTTTGGGACGCAGAGAGTCTAAGGTCTTG
GGTTTTGGGAGTTTTGGGACGCAGAGAGTC|CGAGACTGCTGCGCCAATGGAGGCCTACCC
GCGACTTAGCGAGTCTTCTGTTTTGGGACG|GCAGAGAGTCTAAGGTCTTGCAAGTAGTGT
GGGACGCAGAGAGTCTAAGGTCTTGGGGCG|GGCCCGGTACCTCCAGTAAGTTTGAAAGAC
CTGCGTTGGGTTTTGGGACGCAGAGAGTCT|GAGAGTCTAAGGTCTTGTGTTTTGGGACGC
ACGAAACACCTAAATTCCCAGACTCAGCGC|GACGCAGAGAGTCTAAGGTCTTGTCACATT
GTCAAAGGGTTTTGGGACGCAGAGTTTTGG|AAGGTCTTGTCCCATTTGTCCCAGAAGATT
GCAGTGGTTCCAAGTATCACGGGCTCAGGG|CACCGCTCAATGAAAAGGTGCCGATTGTCG
TCGGGCCCGGTACCTCCAGTAAGTTTGAAA|GCGAGGCCGAAGCGTGGTCTAGATAACATG
GGACGCAGAGTTTTGGGACGCAGAGAGTCT|TTTGTCCCAGAAGATTAAGACAAATCAAGG
TGCAAGTAGTGTCCGAACGTCAAATATACA|CTAAGGTCTTGGCCTATGGCGTGGGGTGTG
AAACTACTCAGGCCACGCGGTTATTCTCCA|GCAGAGAGTCTAAGGTCTTGAAGGTCGTTT
GCAACCTAGTCAGCCTGCAAACTACTCAGG|GAGAGTCTGTTTTGGGACGCAGAGAGTCTA
CTGGCGGTAGCTGGAACGTCAAAGGGTTTT|TGGGACGCAGAGAGTCTAAGGTCTTGTCCC
GGTTTTGGGACGCAGAGTTTTGGGACGCAG|TGTCCCATTTGTCCCAGAAGATTAAGACAA
GGCCGAAGCGTGGTCTAGATAACATGCTAC|AGGCGTAGGGGTTCATCGAAGGGTGATAGC
GAGTCTAAGGTCTTGAAGGTCGTTTTGGGA|GAGAGTCTAAGGTCTTGGGACAGAGAATGA
GAGTCTAAGGTCTTGGCCTATGGCGTGGGG|GTCTAAGGTCTTGGGGCGGCACTGCACAAG
ACGCAGAGAGTCTAAGGTCTTGCGCAGAGA|GGAGGCCTACCCGTCAAGGCGCCCTATACT
GGCACGGAAGATCGCGAAACAAAAGCATTG|ATTTCGTGCAGTGGTTCCAAGTATCACGGG
AACGGTTCTGTTGAGACTCACTTCGCAACC|GCAGAGAGTCTAAGGTCTTGCGCAGAGAGT
TAAGGTCTTGCAAGTAGTGTCCGAACGTCA|CAGAGAGTCTAAGGTCTTGGCCTATGGCGT
CAACGTGATGCGAACCAAAGGGGACTAGGC|TTGGGACGCAGAGAGTCTAAGGTCTTGTCA
CAGAGAGTCTAAGGTCTTGTGTTTTGGGAC|AGGTCTTGATACACAAACGTTTTGGGACGC
TATACAACAAAGCGAGCCAAAAGAGCGCAA|GGTGTGCACAACGTGATGCGAACCAAAGGG
TGCTGCGCCAATGGAGGCCTACCCGTCAAG|TGGAACGTCAAAGGGTTTTGGGACGCAGAG
CCTCCAGTAAGTTTGAAAGACGCCACTTGA|CGTGGTCTAGATAACATGCTACGTTTTGGG
TTGGAGTCTAAGGTCTTGGAACTTCTCTAA|TTAAAGGCGCGCTTTTAGCTCCTGCGTTGG
AAGGTCTTGGGACAGAGAATGATATTGGGC|TCTTGGAACTTCTCTAAGATGGGGCAAGCG
ACTGCTGCGCCAATGGAGGCCTACCCGTCA|GCTGGAACGTCAAAGGGTTTTGGGACGCAG
TTCTGTTTTGGGACGCAGAGAGTCTAAGGT|TCTTGCAAGTAGTGTCCGAACGTCAAATAT
TCTTGGGACAGAGAATGATATTGGGCCTAT|GGAACTTCTCTAAGATGGGGCAAGCGACTT
AACTACTCAGGCCACGCGGTTATTCTCCAA|CAGAGAGTCTAAGGTCTTGAAGGTCGTTTT
GACTGCTGCGCCAATGGAGGCCTACCCGTC|AGCTGGAACGTCAAAGGGTTTTGGGACGCA
GAGGAAAGGACAAATAAATTTCGTGCAGTG|CCAGCCGAAATAGCTTACGGTTAACACCGC
TTTGGGACGCAGAGAGTCTAAGGTCTTGAT|GCAGGCACGGAAGATCGCGAAACAAAAGCA
AGGCGCCCTATACTAGGAAGGTTTTGGGAC|AGTTTTGGGACGCAGAGAGTCTAAGGTCTT
TCTAAGGTCTTGCAAGTAGTGTCCGAACGT|CGCAGAGAGTCTAAGGTCTTGGCCTATGGC
CAAGACTGCACTGTAGATGACTAAGAGGAA|CCCTCGGCAAAGCACTGGTTTTGGGAGTTT
GGGTGTGCACAACGTGATGCGAACCAAAGG|AAGTGTGTTTTGGGACGCAGAGAGTCTAAG
TCCCATTTGTCCCAGAAGATTAAGACAAAT|CAAAGCGAGCCAAAAGAGCGCAAAACCCTG
CCTATACTAGGAAGGTTTTGGGACGCAGAG|GGGACGCAGAGAGTCTAAGGTCTTGGAGTC
AATAAATTTCGTGCAGTGGTTCCAAGTATC|GCTTACGGTTAACACCGCTCAATGAAAAGG
AGTTTTGGGACGCAGAGAGTCTAAGGTCTT|TGCGCCAATGGAGGCCTACCCGTCAAGGCG
GAGAGTCTAAGGTCTTGTCACATTACCCTC|AGGACTGCTAGTATGGCTCATCATAGCGGC
AACCTAGTCAGCCTGCAAACTACTCAGGCC|GAGTCTGTTTTGGGACGCAGAGAGTCTAAG
GGTCTTGGAGTCTAAGGTCTTGGAACTTCT|GCGTTTAAAGGCGCGCTTTTAGCTCCTGCG
GTCTTGGCCTATGGCGTGGGGTGTGCACAA|CTTGGGGCGGCACTGCACAAGTGTGTTTTG
GGTTATTCTCCAACGCCCCAGGACCACAAA|TGAAGGTCGTTTTGGGACGCAGAGAGTCTA
CTTCAGTTGCTGGCGGTAGCTGGAACGTCA|CTTCTGTTTTGGGACGCAGAGAGTCTAAGG
CTGGAACGTCAAAGGGTTTTGGGACGCAGA|AGAGTCTAAGGTCTTGTCCCATTTGTCCCA
CACATTACCCTCCAGCCGAAATAGCTTACG|CATCATAGCGGCAGAGAGCCATAGGCGGAA
GGGACGCAGAGAGTCTAAGGTCTTGTCACA|TGCAATTGAGGACTGCTAGTATGGCTCATC
CGCCACTTGACGAAACACCTAAATTCCCAG|ACGTTTTGGGACGCAGAGAGTCTAAGGTCT
AACGTCAAATATACAACAAAGCGAGCCAAA|ATGGCGTGGGGTGTGCACAACGTGATGCGA
AGAGTCTAAGGTCTTGAAGGTCGTTTTGGG|AGAGAGTCTAAGGTCTTGGGACAGAGAATG
AAGGTCTTGATACACAAACGTTTTGGGACG|AAACAAAAGCATTGCACGTTCTCGGGCCCG
AAGACTGCACTGTAGATGACTAAGAGGAAT|CCTCGGCAAAGCACTGGTTTTGGGAGTTTT
TAACAACGGTTCTGTTGAGACTCACTTCGC|GGACGCAGAGAGTCTAAGGTCTTGCGCAGA
CTCAGCGCTGCATGAGGAAAGGACAAATAA|GTCACATTACCCTCCAGCCGAAATAGCTTA
ATTGCACGTTCTCGGGCCCGGTACCTCCAG|CGGGCTCAGGGGCGAGGCCGAAGCGTGGTC
TGTGTTTTGGGACGCAGAGAGTCTAAGGTC|CGTTTTGGGACGCAGAGAGTCTAAGGTCTT
CCCCTGGTACAGAACAATTGTAAAACGCAA|CTCCAACGCCCCAGGACCACAAAGAGCCCC
ATTAGGAAACCCCGTGGACTTACTCCCCTG|AACTACTCAGGCCACGCGGTTATTCTCCAA
TGTTTTGGGACGCAGAGAGTCTAAGGTCTT|TTTTGGGACGCAGAGAGTCTAAGGTCTTGG
ATGCTACGTTTTGGGACGCAGAGAGTCTAA|TGATAGCTGGCCTGCAATTGAGGACTGCTA
GAGGCCGAAGCGTGGTCTAGATAACATGCT|CAAGGCGTAGGGGTTCATCGAAGGGTGATA
TTGGGACGCAGAGAGTCTAAGGTCTTGGCC|GGGACGCAGAGAGTCTAAGGTCTTGGGGCG
CTAAGGTCTTGGCCTATGGCGTGGGGTGTG|AAGGTCTTGGGGCGGCACTGCACAAGTGTG
TGCACAACGTGATGCGAACCAAAGGGGACT|TGTTTTGGGACGCAGAGAGTCTAAGGTCTT
CTGGTTTTGGGAGTTTTGGGACGCAGAGAG|AGCGAGACTGCTGCGCCAATGGAGGCCTAC
TCAAAGGGTTTTGGGACGCAGAGTTTTGGG|AGGTCTTGTCCCATTTGTCCCAGAAGATTA
CAGTAAGTTTGAAAGACGCCACTTGACGAA|GTCTAGATAACATGCTACGTTTTGGGACGC
CAGAGAATGATATTGGGCCTATACGCGGGC|TCTAAGATGGGGCAAGCGACTTAGCGAGTC
CTCGGGCCCGGTACCTCCAGTAAGTTTGAA|GGCGAGGCCGAAGCGTGGTCTAGATAACAT
GACGCAGAGTTTTGGGACGCAGAGAGTCTA|TTGTCCCAGAAGATTAAGACAAATCAAGGA
GACGCAGAGAGTCTAAGGTCTTGAAGGTCG|GGGACGCAGAGAGTCTAAGGTCTTGGGACA
CTAAGGTCTTGTCACATTACCCTCCAGCCG|GCTAGTATGGCTCATCATAGCGGCAGAGAG
ACGTCAAATATACAACAAAGCGAGCCAAAA|TGGCGTGGGGTGTGCACAACGTGATGCGAA
CGGTTCTGTTGAGACTCACTTCGCAACCTA|AGAGAGTCTAAGGTCTTGCGCAGAGAGTCT
TGGGACGCAGAGAGTCTAAGGTCTTGAAGG|TTTGGGACGCAGAGAGTCTAAGGTCTTGGG
AGTCTAAGGTCTTGTTGAAACTCTAGCGAG|CCTATACGCGGGCTTCAGTTGCTGGCGGTA
GTTTTGGGACGCAGAGAGTCTAAGGTCTTG|GTGCAGGCACGGAAGATCGCGAAACAAAAG
GGCCTACCCGTCAAGGCGCCCTATACTAGG|TTTTGGGACGCAGAGTTTTGGGACGCAGAG
ACAAGTTTTGGGACGCAGAGAGTCTAAGGT|GACGCAGAGAGTCTAAGGTCTTGATACACA
TTGAAAGACGCCACTTGACGAAACACCTAA|AACATGCTACGTTTTGGGACGCAGAGAGTC
GTCTTGTTGAAACTCTAGCGAGACTGCTGC|CGGGCTTCAGTTGCTGGCGGTAGCTGGAAC
AAGGGGACTAGGCTCCGTCCGTTTTGGGAC|TAAGGTCTTGTCAAGCACGCGTGCAGGCAC
AAAGGGTTTTGGGACGCAGAGTTTTGGGAC|GTCTTGTCCCATTTGTCCCAGAAGATTAAG
TTTGGGACGCAGAGAGTCTAAGGTCTTGTG|GAGAGTCTAAGGTCTTGATACACAAACGTT
TAAGACAAATCAAGGACGCGTTTAAAGGCG|CAAAACCCTGGTCATCAAAGTCTATACAAG
GGCGCGCTTTTAGCTCCTGCGTTGGGTTTT|CAAGTTTTGGGACGCAGAGAGTCTAAGGTC
AAGTTTTGGGACGCAGAGAGTCTAAGGTCT|CGCAGAGAGTCTAAGGTCTTGATACACAAA
GACGCAGAGAGTCTAAGGTCTTGCAAGTAG|GTGTTTTGGGACGCAGAGAGTCTAAGGTCT
GGTAGCTGGAACGTCAAAGGGTTTTGGGAC|CGCAGAGAGTCTAAGGTCTTGTCCCATTTG
AACATGCTACGTTTTGGGACGCAGAGAGTC|GGGTGATAGCTGGCCTGCAATTGAGGACTG
TAGTCAGCCTGCAAACTACTCAGGCCACGC|CTGTTTTGGGACGCAGAGAGTCTAAGGTCT
TCCAACGCCCCAGGACCACAAAGAGCCCCT|GTTTTGGGACGCAGAGAGTCTAAGGTCTTG
TTCTGTTGAGACTCACTTCGCAACCTAGTC|GAGTCTAAGGTCTTGCGCAGAGAGTCTGTT
GCACGTTCTCGGGCCCGGTACCTCCAGTAA|GCTCAGGGGCGAGGCCGAAGCGTGGTCTAG
ATACACAAACGTTTTGGGACGCAGAGAGTC|CATTGCACGTTCTCGGGCCCGGTACCTCCA
CACTGTAGATGACTAAGAGGAATGTAACAA|AAAGCACTGGTTTTGGGAGTTTTGGGACGC
AAATTTCGTGCAGTGGTTCCAAGTATCACG|TACGGTTAACACCGCTCAATGAAAAGGTGC
TAGGCTCCGTCCGTTTTGGGACGCAGAGAG|TGTCAAGCACGCGTGCAGGCACGGAAGATC
TACAGAACAATTGTAAAACGCAAGACTGCA|GCCCCAGGACCACAAAGAGCCCCTCGGCAA
GTTGCTGGCGGTAGCTGGAACGTCAAAGGG|GTTTTGGGACGCAGAGAGTCTAAGGTCTTG
AAGGTCTTGGAGTCTAAGGTCTTGGAACTT|ACGCGTTTAAAGGCGCGCTTTTAGCTCCTG
TCTAAGGTCTTGGAGTCTAAGGTCTTGGAA|AGGACGCGTTTAAAGGCGCGCTTTTAGCTC
CTCCAGTAAGTTTGAAAGACGCCACTTGAC|GTGGTCTAGATAACATGCTACGTTTTGGGA
GCAGAGAGTCTAAGGTCTTGGAGTCTAAGG|ACAAATCAAGGACGCGTTTAAAGGCGCGCT
CTAGATAACATGCTACGTTTTGGGACGCAG|ATCGAAGGGTGATAGCTGGCCTGCAATTGA
CTTGGGGCGGCACTGCACAAGTGTGTTTTG|TTGAAAGACGCCACTTGACGAAACACCTAA
ACGTGATGCGAACCAAAGGGGACTAGGCTC|GGGACGCAGAGAGTCTAAGGTCTTGTCAAG
GGACGCAGAGAGTCTAAGGTCTTGATACAC|GCACGGAAGATCGCGAAACAAAAGCATTGC
GCATGAGGAAAGGACAAATAAATTTCGTGC|CCCTCCAGCCGAAATAGCTTACGGTTAACA
GTCTAAGGTCTTGGGGCGGCACTGCACAAG|CCAGTAAGTTTGAAAGACGCCACTTGACGA
CATGAGGAAAGGACAAATAAATTTCGTGCA|CCTCCAGCCGAAATAGCTTACGGTTAACAC
GCGAAACAAAAGCATTGCACGTTCTCGGGC|GTTCCAAGTATCACGGGCTCAGGGGCGAGG
TATACTAGGAAGGTTTTGGGACGCAGAGAG|GACGCAGAGAGTCTAAGGTCTTGGAGTCTA
GGGTTTTGGGACGCAGAGTTTTGGGACGCA|TTGTCCCATTTGTCCCAGAAGATTAAGACA
TGGGACAGAGAATGATATTGGGCCTATACG|ACTTCTCTAAGATGGGGCAAGCGACTTAGC
AAATTCCCAGACTCAGCGCTGCATGAGGAA|TCTAAGGTCTTGTCACATTACCCTCCAGCC
GACTTACTCCCCTGGTACAGAACAATTGTA|CGGTTATTCTCCAACGCCCCAGGACCACAA
CGCAGAGAGTCTAAGGTCTTGGCCTATGGC|CAGAGAGTCTAAGGTCTTGGGGCGGCACTG
ACAAAGAGCCCCTCGGCAAAGCACTGGTTT|GTCTAAGGTCTTGTTGAAACTCTAGCGAGA
CCGTCCGTTTTGGGACGCAGAGAGTCTAAG|GCACGCGTGCAGGCACGGAAGATCGCGAAA
CCTATGGCGTGGGGTGTGCACAACGTGATG|CGGCACTGCACAAGTGTGTTTTGGGACGCA
TACTAGGAAGGTTTTGGGACGCAGAGAGTC|CGCAGAGAGTCTAAGGTCTTGGAGTCTAAG
CTGGTCATCAAAGTCTATACAAGTTTTGGG|AGGCTCCGTCCGTTTTGGGACGCAGAGAGT
GGGACGCAGAGAGTCTAAGGTCTTGGGACA|GTCTTGGAGTCTAAGGTCTTGGAACTTCTC
CGCAGAGAGTCTAAGGTCTTGGGGCGGCAC|CGGTACCTCCAGTAAGTTTGAAAGACGCCA
TCCCCTGGTACAGAACAATTGTAAAACGCA|TCTCCAACGCCCCAGGACCACAAAGAGCCC
CGCAGAGAGTCTAAGGTCTTGATACACAAA|CGGAAGATCGCGAAACAAAAGCATTGCACG
ACCCGTCAAGGCGCCCTATACTAGGAAGGT|GGACGCAGAGTTTTGGGACGCAGAGAGTCT
GTCTAAGGTCTTGGGACAGAGAATGATATT|AAGGTCTTGGAACTTCTCTAAGATGGGGCA
GTGTGTTTTGGGACGCAGAGAGTCTAAGGT|AAACACCTAAATTCCCAGACTCAGCGCTGC
CCAGACTCAGCGCTGCATGAGGAAAGGACA|GTCTTGTCACATTACCCTCCAGCCGAAATA
GGCAAGCGACTTAGCGAGTCTTCTGTTTTG|GGGACGCAGAGAGTCTAAGGTCTTGCAAGT
TCCAGCCGAAATAGCTTACGGTTAACACCG|GCAGAGAGCCATAGGCGGAATATAATGGTG
AAAACCCTGGTCATCAAAGTCTATACAAGT|GGGACTAGGCTCCGTCCGTTTTGGGACGCA
GCGCGCTTTTAGCTCCTGCGTTGGGTTTTG|AAGTTTTGGGACGCAGAGAGTCTAAGGTCT
GTCTAAGGTCTTGCGCAGAGAGTCTGTTTT|CCCGTCAAGGCGCCCTATACTAGGAAGGTT
TCTTGTTGAAACTCTAGCGAGACTGCTGCG|GGGCTTCAGTTGCTGGCGGTAGCTGGAACG
AGATCGCGAAACAAAAGCATTGCACGTTCT|CAGTGGTTCCAAGTATCACGGGCTCAGGGG
CGAGACTGCTGCGCCAATGGAGGCCTACCC|GGTAGCTGGAACGTCAAAGGGTTTTGGGAC
CCTAAATTCCCAGACTCAGCGCTGCATGAG|GAGTCTAAGGTCTTGTCACATTACCCTCCA
ACGCAGAGAGTCTAAGGTCTTGGCCTATGG|GCAGAGAGTCTAAGGTCTTGGGGCGGCACT
TGTTGAGACTCACTTCGCAACCTAGTCAGC|TCTAAGGTCTTGCGCAGAGAGTCTGTTTTG
GCTCCTGCGTTGGGTTTTGGGACGCAGAGA|CGCAGAGAGTCTAAGGTCTTGTGTTTTGGG
CGTCCGTTTTGGGACGCAGAGAGTCTAAGG|CACGCGTGCAGGCACGGAAGATCGCGAAAC
ATTGGGCCTATACGCGGGCTTCAGTTGCTG|GCAAGCGACTTAGCGAGTCTTCTGTTTTGG
AGGTCTTGAAGGTCGTTTTGGGACGCAGAG|TAAGGTCTTGGGACAGAGAATGATATTGGG
CAAACTACTCAGGCCACGCGGTTATTCTCC|CGCAGAGAGTCTAAGGTCTTGAAGGTCGTT
CCCTCCAGCCGAAATAGCTTACGGTTAACA|GCGGCAGAGAGCCATAGGCGGAATATAATG
TCTAAGGTCTTGTGTTTTGGGACGCAGAGA|GATACACAAACGTTTTGGGACGCAGAGAGT
GTTATTCTCCAACGCCCCAGGACCACAAAG|GAAGGTCGTTTTGGGACGCAGAGAGTCTAA
GGAGTCTAAGGTCTTGGAACTTCTCTAAGA|AAAGGCGCGCTTTTAGCTCCTGCGTTGGGT
GCAGAGAGTCTAAGGTCTTGTCACATTACC|TTGAGGACTGCTAGTATGGCTCATCATAGC
TCCAAGTATCACGGGCTCAGGGGCGAGGCC|AATGAAAAGGTGCCGATTGTCGCTCAAGGC
AGTCTAAGGTCTTGCAAGTAGTGTCCGAAC|GACGCAGAGAGTCTAAGGTCTTGGCCTATG
GGCGCCCTATACTAGGAAGGTTTTGGGACG|GTTTTGGGACGCAGAGAGTCTAAGGTCTTG
CTAAATTCCCAGACTCAGCGCTGCATGAGG|AGTCTAAGGTCTTGTCACATTACCCTCCAG
CCAGGACCACAAAGAGCCCCTCGGCAAAGC|CGCAGAGAGTCTAAGGTCTTGTTGAAACTC
CCAGTAAGTTTGAAAGACGCCACTTGACGA|GGTCTAGATAACATGCTACGTTTTGGGACG
GTGTCCGAACGTCAAATATACAACAAAGCG|TTGGCCTATGGCGTGGGGTGTGCACAACGT
GAACCAAAGGGGACTAGGCTCCGTCCGTTT|AGAGTCTAAGGTCTTGTCAAGCACGCGTGC
TGCTGGCGGTAGCTGGAACGTCAAAGGGTT|TTTGGGACGCAGAGAGTCTAAGGTCTTGTC
TGTCAAGCACGCGTGCAGGCACGGAAGATC|GAGGAAAGGACAAATAAATTTCGTGCAGTG
ATACAAGTTTTGGGACGCAGAGAGTCTAAG|GGGACGCAGAGAGTCTAAGGTCTTGATACA
GCACGGAAGATCGCGAAACAAAAGCATTGC|TTTCGTGCAGTGGTTCCAAGTATCACGGGC
CTACCCGTCAAGGCGCCCTATACTAGGAAG|TGGGACGCAGAGTTTTGGGACGCAGAGAGT
CTCGGCAAAGCACTGGTTTTGGGAGTTTTG|TGTTGAAACTCTAGCGAGACTGCTGCGCCA
CGCAGAGAGTCTAAGGTCTTGTCACATTAC|ATTGAGGACTGCTAGTATGGCTCATCATAG
CAAATCAAGGACGCGTTTAAAGGCGCGCTT|CCCTGGTCATCAAAGTCTATACAAGTTTTG
AAAGCACTGGTTTTGGGAGTTTTGGGACGC|AACTCTAGCGAGACTGCTGCGCCAATGGAG
CCAAGTATCACGGGCTCAGGGGCGAGGCCG|ATGAAAAGGTGCCGATTGTCGCTCAAGGCG
TTGGGACGCAGAGAGTCTAAGGTCTTGAAG|TTTTGGGACGCAGAGAGTCTAAGGTCTTGG
AGGCGCGCTTTTAGCTCCTGCGTTGGGTTT|ACAAGTTTTGGGACGCAGAGAGTCTAAGGT
GGACGCAGAGAGTCTAAGGTCTTGCGCAGA|ATGGAGGCCTACCCGTCAAGGCGCCCTATA
GTTTTGGGACGCAGAGAGTCTAAGGTCTTG|CAGAGAGTCTAAGGTCTTGATACACAAACG
TGGAGGCCTACCCGTCAAGGCGCCCTATAC|AGGGTTTTGGGACGCAGAGTTTTGGGACGC
CCCCGTGGACTTACTCCCCTGGTACAGAAC|GGCCACGCGGTTATTCTCCAACGCCCCAGG
ACAAATCAAGGACGCGTTTAAAGGCGCGCT|ACCCTGGTCATCAAAGTCTATACAAGTTTT
TTCCCAGACTCAGCGCTGCATGAGGAAAGG|AAGGTCTTGTCACATTACCCTCCAGCCGAA
CACGGGCTCAGGGGCGAGGCCGAAGCGTGG|GTGCCGATTGTCGCTCAAGGCGTAGGGGTT
GCGCTGCATGAGGAAAGGACAAATAAATTT|CATTACCCTCCAGCCGAAATAGCTTACGGT
CGAGGCCGAAGCGTGGTCTAGATAACATGC|TCAAGGCGTAGGGGTTCATCGAAGGGTGAT
CGAACGTCAAATATACAACAAAGCGAGCCA|CTATGGCGTGGGGTGTGCACAACGTGATGC
AGATGGGGCAAGCGACTTAGCGAGTCTTCT|GGTTTTGGGACGCAGAGAGTCTAAGGTCTT
CTGCTGCGCCAATGGAGGCCTACCCGTCAA|CTGGAACGTCAAAGGGTTTTGGGACGCAGA
TTTTGGGACGCAGAGAGTCTAAGGTCTTGG|AAGATTAAGACAAATCAAGGACGCGTTTAA
ATTCCCAGACTCAGCGCTGCATGAGGAAAG|TAAGGTCTTGTCACATTACCCTCCAGCCGA
AGAGAGTCTAAGGTCTTGGGGCGGCACTGC|TACCTCCAGTAAGTTTGAAAGACGCCACTT
CGGGCTTCAGTTGCTGGCGGTAGCTGGAAC|GAGTCTTCTGTTTTGGGACGCAGAGAGTCT
CCTGGTCATCAAAGTCTATACAAGTTTTGG|TAGGCTCCGTCCGTTTTGGGACGCAGAGAG
ACTTACTCCCCTGGTACAGAACAATTGTAA|GGTTATTCTCCAACGCCCCAGGACCACAAA
TCTTCTGTTTTGGGACGCAGAGAGTCTAAG|GGTCTTGCAAGTAGTGTCCGAACGTCAAAT
GCGTGGGGTGTGCACAACGTGATGCGAACC|TGCACAAGTGTGTTTTGGGACGCAGAGAGT
GACTCACTTCGCAACCTAGTCAGCCTGCAA|GTCTTGCGCAGAGAGTCTGTTTTGGGACGC
AGTCTAAGGTCTTGGGACAGAGAATGATAT|TAAGGTCTTGGAACTTCTCTAAGATGGGGC
TGCGTTGGGTTTTGGGACGCAGAGAGTCTA|AGAGTCTAAGGTCTTGTGTTTTGGGACGCA
AGATGACTAAGAGGAATGTAACAACGGTTC|CTGGTTTTGGGAGTTTTGGGACGCAGAGAG
CGTTTTGGGACGCAGAGAGTCTAAGGTCTT|CTGGCCTGCAATTGAGGACTGCTAGTATGG
TCTAAGGTCTTGCGCAGAGAGTCTGTTTTG|CCGTCAAGGCGCCCTATACTAGGAAGGTTT
TTTTGGGACGCAGAGAGTCTAAGGTCTTGA|GGTTTTGGGACGCAGAGAGTCTAAGGTCTT
GTTCTCGGGCCCGGTACCTCCAGTAAGTTT|AGGGGCGAGGCCGAAGCGTGGTCTAGATAA
TGGACTTACTCCCCTGGTACAGAACAATTG|CGCGGTTATTCTCCAACGCCCCAGGACCAC
CCTGCGTTGGGTTTTGGGACGCAGAGAGTC|AGAGAGTCTAAGGTCTTGTGTTTTGGGACG
TGTTGAAACTCTAGCGAGACTGCTGCGCCA|CTTCAGTTGCTGGCGGTAGCTGGAACGTCA
GCGTGGTCTAGATAACATGCTACGTTTTGG|GGGGTTCATCGAAGGGTGATAGCTGGCCTG
GCGTTGGGTTTTGGGACGCAGAGAGTCTAA|GAGTCTAAGGTCTTGTGTTTTGGGACGCAG
AAAAGCATTGCACGTTCTCGGGCCCGGTAC|GTATCACGGGCTCAGGGGCGAGGCCGAAGC
TGTGTTTTGGGACGCAGAGAGTCTAAGGTC|AACACCTAAATTCCCAGACTCAGCGCTGCA
CCAATTAGGAAACCCCGTGGACTTACTCCC|GCAAACTACTCAGGCCACGCGGTTATTCTC
GACGCAGAGAGTCTAAGGTCTTGCGCAGAG|TGGAGGCCTACCCGTCAAGGCGCCCTATAC
GAACAATTGTAAAACGCAAGACTGCACTGT|CAGGACCACAAAGAGCCCCTCGGCAAAGCA
ACCAAAGGGGACTAGGCTCCGTCCGTTTTG|AGTCTAAGGTCTTGTCAAGCACGCGTGCAG
GACGCAGAGAGTCTAAGGTCTTGTTGAAAC|GATATTGGGCCTATACGCGGGCTTCAGTTG
CAAGGACGCGTTTAAAGGCGCGCTTTTAGC|GTCATCAAAGTCTATACAAGTTTTGGGACG
CTTTTAGCTCCTGCGTTGGGTTTTGGGACG|TTGGGACGCAGAGAGTCTAAGGTCTTGTGT
GGACGCAGAGAGTCTAAGGTCTTGTCACAT|GCAATTGAGGACTGCTAGTATGGCTCATCA
CCCTGGTACAGAACAATTGTAAAACGCAAG|TCCAACGCCCCAGGACCACAAAGAGCCCCT
GAAGCGTGGTCTAGATAACATGCTACGTTT|GTAGGGGTTCATCGAAGGGTGATAGCTGGC
AGCGCAAAACCCTGGTCATCAAAGTCTATA|CAAAGGGGACTAGGCTCCGTCCGTTTTGGG
ACTCACTTCGCAACCTAGTCAGCCTGCAAA|TCTTGCGCAGAGAGTCTGTTTTGGGACGCA
TTTGGGACGCAGAGAGTCTAAGGTCTTGGA|AGATTAAGACAAATCAAGGACGCGTTTAAA
TTCTCTAAGATGGGGCAAGCGACTTAGCGA|TGCGTTGGGTTTTGGGACGCAGAGAGTCTA
TCTAAGGTCTTGGAACTTCTCTAAGATGGG|GCGCGCTTTTAGCTCCTGCGTTGGGTTTTG
AGAGAGTCTAAGGTCTTGTCAAGCACGCGT|AGACTCAGCGCTGCATGAGGAAAGGACAAA
TTTGGGACGCAGAGAGTCTAAGGTCTTGTC|CTAAATTCCCAGACTCAGCGCTGCATGAGG
CAGACTCAGCGCTGCATGAGGAAAGGACAA|TCTTGTCACATTACCCTCCAGCCGAAATAG
GTTTTGGGACGCAGAGAGTCTAAGGTCTTG|AGAGAATGATATTGGGCCTATACGCGGGCT
CTAGGCTCCGTCCGTTTTGGGACGCAGAGA|TTGTCAAGCACGCGTGCAGGCACGGAAGAT
TACTCCCCTGGTACAGAACAATTGTAAAAC|TATTCTCCAACGCCCCAGGACCACAAAGAG
GAGTCTAAGGTCTTGTCACATTACCCTCCA|GACTGCTAGTATGGCTCATCATAGCGGCAG
TGGCGGTAGCTGGAACGTCAAAGGGTTTTG|GGGACGCAGAGAGTCTAAGGTCTTGTCCCA
GGGGCAAGCGACTTAGCGAGTCTTCTGTTT|TTGGGACGCAGAGAGTCTAAGGTCTTGCAA
GAGAGTCTAAGGTCTTGGAGTCTAAGGTCT|AATCAAGGACGCGTTTAAAGGCGCGCTTTT
TGGGACGCAGAGAGTCTAAGGTCTTGATAC|AGGCACGGAAGATCGCGAAACAAAAGCATT
AGTCTAAGGTCTTGCGCAGAGAGTCTGTTT|ACCCGTCAAGGCGCCCTATACTAGGAAGGT
GAGAGTCTAAGGTCTTGTCAAGCACGCGTG|GACTCAGCGCTGCATGAGGAAAGGACAAAT
ACAAGTGTGTTTTGGGACGCAGAGAGTCTA|GACGAAACACCTAAATTCCCAGACTCAGCG
ATCACGGGCTCAGGGGCGAGGCCGAAGCGT|AGGTGCCGATTGTCGCTCAAGGCGTAGGGG
CTGGTACAGAACAATTGTAAAACGCAAGAC|CAACGCCCCAGGACCACAAAGAGCCCCTCG
TCAGTTGCTGGCGGTAGCTGGAACGTCAAA|TCTGTTTTGGGACGCAGAGAGTCTAAGGTC
CGAACCAAAGGGGACTAGGCTCCGTCCGTT|GAGAGTCTAAGGTCTTGTCAAGCACGCGTG
AATGGAGGCCTACCCGTCAAGGCGCCCTAT|AAAGGGTTTTGGGACGCAGAGTTTTGGGAC
TCAGGCCACGCGGTTATTCTCCAACGCCCC|GTCTAAGGTCTTGAAGGTCGTTTTGGGACG
AAGGCGCGCTTTTAGCTCCTGCGTTGGGTT|TACAAGTTTTGGGACGCAGAGAGTCTAAGG
GTATCACGGGCTCAGGGGCGAGGCCGAAGC|AAAGGTGCCGATTGTCGCTCAAGGCGTAGG
CCTCCAGCCGAAATAGCTTACGGTTAACAC|CGGCAGAGAGCCATAGGCGGAATATAATGG
TGCACAAGTGTGTTTTGGGACGCAGAGAGT|CTTGACGAAACACCTAAATTCCCAGACTCA
TGTCCCAGAAGATTAAGACAAATCAAGGAC|AGCCAAAAGAGCGCAAAACCCTGGTCATCA
GGACCACAAAGAGCCCCTCGGCAAAGCACT|AGAGAGTCTAAGGTCTTGTTGAAACTCTAG
AAACCCTGGTCATCAAAGTCTATACAAGTT|GGACTAGGCTCCGTCCGTTTTGGGACGCAG
CATGCTACGTTTTGGGACGCAGAGAGTCTA|GTGATAGCTGGCCTGCAATTGAGGACTGCT
ACTCAGCGCTGCATGAGGAAAGGACAAATA|TGTCACATTACCCTCCAGCCGAAATAGCTT
TGGGACGCAGAGTTTTGGGACGCAGAGAGT|CATTTGTCCCAGAAGATTAAGACAAATCAA
CATTGCACGTTCTCGGGCCCGGTACCTCCA|ACGGGCTCAGGGGCGAGGCCGAAGCGTGGT
TCACTTCGCAACCTAGTCAGCCTGCAAACT|TTGCGCAGAGAGTCTGTTTTGGGACGCAGA
GAGAGTCTAAGGTCTTGGGGCGGCACTGCA|ACCTCCAGTAAGTTTGAAAGACGCCACTTG
CAGAGAGTCTAAGGTCTTGGGACAGAGAAT|GAGTCTAAGGTCTTGGAACTTCTCTAAGAT
CGCTGCATGAGGAAAGGACAAATAAATTTC|ATTACCCTCCAGCCGAAATAGCTTACGGTT
CACAAAGAGCCCCTCGGCAAAGCACTGGTT|AGTCTAAGGTCTTGTTGAAACTCTAGCGAG
TTTTGGGACGCAGAGAGTCTAAGGTCTTGC|CGCCAATGGAGGCCTACCCGTCAAGGCGCC
GAGTCTTCTGTTTTGGGACGCAGAGAGTCT|TAAGGTCTTGCAAGTAGTGTCCGAACGTCA
TCAGGGGCGAGGCCGAAGCGTGGTCTAGAT|TTGTCGCTCAAGGCGTAGGGGTTCATCGAA
AAACCCCGTGGACTTACTCCCCTGGTACAG|TCAGGCCACGCGGTTATTCTCCAACGCCCC
CGCGCTTTTAGCTCCTGCGTTGGGTTTTGG|AGTTTTGGGACGCAGAGAGTCTAAGGTCTT
GTCAAGGCGCCCTATACTAGGAAGGTTTTG|GCAGAGTTTTGGGACGCAGAGAGTCTAAGG
AGGGGACTAGGCTCCGTCCGTTTTGGGACG|AAGGTCTTGTCAAGCACGCGTGCAGGCACG
TAGATAACATGCTACGTTTTGGGACGCAGA|TCGAAGGGTGATAGCTGGCCTGCAATTGAG
AGAGAGTCTAAGGTCTTGTCCCATTTGTCC|CGAACGTCAAATATACAACAAAGCGAGCCA
CAAACGTTTTGGGACGCAGAGAGTCTAAGG|CACGTTCTCGGGCCCGGTACCTCCAGTAAG
GAGGAATGTAACAACGGTTCTGTTGAGACT|GAGTTTTGGGACGCAGAGAGTCTAAGGTCT
AGGTCTTGTTGAAACTCTAGCGAGACTGCT|CGCGGGCTTCAGTTGCTGGCGGTAGCTGGA
GAAACAAAAGCATTGCACGTTCTCGGGCCC|TCCAAGTATCACGGGCTCAGGGGCGAGGCC
GTCTAAGGTCTTGGAGTCTAAGGTCTTGGA|AAGGACGCGTTTAAAGGCGCGCTTTTAGCT
AGCGTGGTCTAGATAACATGCTACGTTTTG|AGGGGTTCATCGAAGGGTGATAGCTGGCCT
GTTTTGGGACGCAGAGAGTCTAAGGTCTTG|GCAAGTAGTGTCCGAACGTCAAATATACAA
AAGGTCTTGGGGCGGCACTGCACAAGTGTG|TAAGTTTGAAAGACGCCACTTGACGAAACA
AGAGAGTCTAAGGTCTTGTCACATTACCCT|GAGGACTGCTAGTATGGCTCATCATAGCGG
GGTCTTGTTGAAACTCTAGCGAGACTGCTG|GCGGGCTTCAGTTGCTGGCGGTAGCTGGAA
CCATTTGTCCCAGAAGATTAAGACAAATCA|AAGCGAGCCAAAAGAGCGCAAAACCCTGGT
GGAGTTTTGGGACGCAGAGAGTCTAAGGTC|GCTGCGCCAATGGAGGCCTACCCGTCAAGG
AGATAACATGCTACGTTTTGGGACGCAGAG|CGAAGGGTGATAGCTGGCCTGCAATTGAGG
ATGTAACAACGGTTCTGTTGAGACTCACTT|TTGGGACGCAGAGAGTCTAAGGTCTTGCGC
AGGACAAATAAATTTCGTGCAGTGGTTCCA|GAAATAGCTTACGGTTAACACCGCTCAATG
TTTTGGGACGCAGAGAGTCTAAGGTCTTGT|CCTAAATTCCCAGACTCAGCGCTGCATGAG
TATCACGGGCTCAGGGGCGAGGCCGAAGCG|AAGGTGCCGATTGTCGCTCAAGGCGTAGGG
GGACTTACTCCCCTGGTACAGAACAATTGT|GCGGTTATTCTCCAACGCCCCAGGACCACA
GCTGCGCCAATGGAGGCCTACCCGTCAAGG|GGAACGTCAAAGGGTTTTGGGACGCAGAGT
TGGAACGTCAAAGGGTTTTGGGACGCAGAG|GAGTCTAAGGTCTTGTCCCATTTGTCCCAG
TGAAAGACGCCACTTGACGAAACACCTAAA|ACATGCTACGTTTTGGGACGCAGAGAGTCT
TTTGGGAGTTTTGGGACGCAGAGAGTCTAA|GACTGCTGCGCCAATGGAGGCCTACCCGTC
CAGAGAGTCTAAGGTCTTGAAGGTCGTTTT|CGCAGAGAGTCTAAGGTCTTGGGACAGAGA
TTGTCCCAGAAGATTAAGACAAATCAAGGA|GAGCCAAAAGAGCGCAAAACCCTGGTCATC
GGCTTCAGTTGCTGGCGGTAGCTGGAACGT|GTCTTCTGTTTTGGGACGCAGAGAGTCTAA
CCCTGGTCATCAAAGTCTATACAAGTTTTG|CTAGGCTCCGTCCGTTTTGGGACGCAGAGA
AAAGAGCCCCTCGGCAAAGCACTGGTTTTG|CTAAGGTCTTGTTGAAACTCTAGCGAGACT
AGTCTAAGGTCTTGTCACATTACCCTCCAG|ACTGCTAGTATGGCTCATCATAGCGGCAGA
GTCTATACAAGTTTTGGGACGCAGAGAGTC|TTTTGGGACGCAGAGAGTCTAAGGTCTTGA
GAAGATCGCGAAACAAAAGCATTGCACGTT|TGCAGTGGTTCCAAGTATCACGGGCTCAGG
ACGCAGAGAGTCTAAGGTCTTGCAAGTAGT|TGTTTTGGGACGCAGAGAGTCTAAGGTCTT
TTTGTCCCAGAAGATTAAGACAAATCAAGG|CGAGCCAAAAGAGCGCAAAACCCTGGTCAT
AAGCGAGCCAAAAGAGCGCAAAACCCTGGT|AACGTGATGCGAACCAAAGGGGACTAGGCT
AGAGTCTAAGGTCTTGGGGCGGCACTGCAC|CCTCCAGTAAGTTTGAAAGACGCCACTTGA
ACCACAAAGAGCCCCTCGGCAAAGCACTGG|AGAGTCTAAGGTCTTGTTGAAACTCTAGCG
TCTAAGGTCTTGGGGCGGCACTGCACAAGT|CAGTAAGTTTGAAAGACGCCACTTGACGAA
CTTCGCAACCTAGTCAGCCTGCAAACTACT|CGCAGAGAGTCTGTTTTGGGACGCAGAGAG
ATGACTAAGAGGAATGTAACAACGGTTCTG|GGTTTTGGGAGTTTTGGGACGCAGAGAGTC
CTTGTCACATTACCCTCCAGCCGAAATAGC|TGGCTCATCATAGCGGCAGAGAGCCATAGG
AAAACGCAAGACTGCACTGTAGATGACTAA|AAGAGCCCCTCGGCAAAGCACTGGTTTTGG
TAGCGAGACTGCTGCGCCAATGGAGGCCTA|GGCGGTAGCTGGAACGTCAAAGGGTTTTGG
TAAGGTCTTGTCCCATTTGTCCCAGAAGAT|AAATATACAACAAAGCGAGCCAAAAGAGCG
CGCGGTTATTCTCCAACGCCCCAGGACCAC|TCTTGAAGGTCGTTTTGGGACGCAGAGAGT
GTCTGTTTTGGGACGCAGAGAGTCTAAGGT|AGGAAGGTTTTGGGACGCAGAGAGTCTAAG
CTTGGAACTTCTCTAAGATGGGGCAAGCGA|TTAGCTCCTGCGTTGGGTTTTGGGACGCAG
GAGTCTAAGGTCTTGTCCCATTTGTCCCAG|ACGTCAAATATACAACAAAGCGAGCCAAAA
CTAGCGAGACTGCTGCGCCAATGGAGGCCT|TGGCGGTAGCTGGAACGTCAAAGGGTTTTG
GGTACAGAACAATTGTAAAACGCAAGACTG|ACGCCCCAGGACCACAAAGAGCCCCTCGGC
TATGGCGTGGGGTGTGCACAACGTGATGCG|GCACTGCACAAGTGTGTTTTGGGACGCAGA
GTCATCAAAGTCTATACAAGTTTTGGGACG|CTCCGTCCGTTTTGGGACGCAGAGAGTCTA
CGCAGAGAGTCTAAGGTCTTGAAGGTCGTT|GACGCAGAGAGTCTAAGGTCTTGGGACAGA
TGCGCCAATGGAGGCCTACCCGTCAAGGCG|AACGTCAAAGGGTTTTGGGACGCAGAGTTT
ACAACAAAGCGAGCCAAAAGAGCGCAAAAC|GTGCACAACGTGATGCGAACCAAAGGGGAC
TCTGTTTTGGGACGCAGAGAGTCTAAGGTC|CTTGCAAGTAGTGTCCGAACGTCAAATATA
GAACGTCAAAGGGTTTTGGGACGCAGAGTT|GTCTAAGGTCTTGTCCCATTTGTCCCAGAA
TTGGGAGTTTTGGGACGCAGAGAGTCTAAG|ACTGCTGCGCCAATGGAGGCCTACCCGTCA
GTCTAAGGTCTTGAAGGTCGTTTTGGGACG|GAGTCTAAGGTCTTGGGACAGAGAATGATA
TAAAGGCGCGCTTTTAGCTCCTGCGTTGGG|TATACAAGTTTTGGGACGCAGAGAGTCTAA
AGGGGCGAGGCCGAAGCGTGGTCTAGATAA|GTCGCTCAAGGCGTAGGGGTTCATCGAAGG
AGAGTCTAAGGTCTTGGGACAGAGAATGAT|TCTAAGGTCTTGGAACTTCTCTAAGATGGG
CGCGTGCAGGCACGGAAGATCGCGAAACAA|ACAAATAAATTTCGTGCAGTGGTTCCAAGT
GTAAAACGCAAGACTGCACTGTAGATGACT|CAAAGAGCCCCTCGGCAAAGCACTGGTTTT
GAGAGTCTAAGGTCTTGTTGAAACTCTAGC|GGGCCTATACGCGGGCTTCAGTTGCTGGCG
GACGCAGAGAGTCTAAGGTCTTGATACACA|CACGGAAGATCGCGAAACAAAAGCATTGCA
TGCACGTTCTCGGGCCCGGTACCTCCAGTA|GGCTCAGGGGCGAGGCCGAAGCGTGGTCTA
AGAAGATTAAGACAAATCAAGGACGCGTTT|AAGAGCGCAAAACCCTGGTCATCAAAGTCT
TCTTGTGTTTTGGGACGCAGAGAGTCTAAG|AAACGTTTTGGGACGCAGAGAGTCTAAGGT
AGCTGGAACGTCAAAGGGTTTTGGGACGCA|AGAGAGTCTAAGGTCTTGTCCCATTTGTCC
AGCGAGCCAAAAGAGCGCAAAACCCTGGTC|ACGTGATGCGAACCAAAGGGGACTAGGCTC
AGGTCTTGGGGCGGCACTGCACAAGTGTGT|AAGTTTGAAAGACGCCACTTGACGAAACAC
GTGTTTTGGGACGCAGAGAGTCTAAGGTCT|GTTTTGGGACGCAGAGAGTCTAAGGTCTTG
GCGAGGCCGAAGCGTGGTCTAGATAACATG|CTCAAGGCGTAGGGGTTCATCGAAGGGTGA
TGGGACGCAGAGAGTCTAAGGTCTTGTCCC|GTAGTGTCCGAACGTCAAATATACAACAAA
TTTTGGGAGTTTTGGGACGCAGAGAGTCTA|AGACTGCTGCGCCAATGGAGGCCTACCCGT
GGGGTGTGCACAACGTGATGCGAACCAAAG|CAAGTGTGTTTTGGGACGCAGAGAGTCTAA
AGGTCTTGTGTTTTGGGACGCAGAGAGTCT|CACAAACGTTTTGGGACGCAGAGAGTCTAA
CGCGTTTAAAGGCGCGCTTTTAGCTCCTGC|AAAGTCTATACAAGTTTTGGGACGCAGAGA
TGCGAACCAAAGGGGACTAGGCTCCGTCCG|CAGAGAGTCTAAGGTCTTGTCAAGCACGCG
GCGGTTATTCTCCAACGCCCCAGGACCACA|CTTGAAGGTCGTTTTGGGACGCAGAGAGTC
ATCAAGGACGCGTTTAAAGGCGCGCTTTTA|TGGTCATCAAAGTCTATACAAGTTTTGGGA
TAAAACGCAAGACTGCACTGTAGATGACTA|AAAGAGCCCCTCGGCAAAGCACTGGTTTTG
CCCTATACTAGGAAGGTTTTGGGACGCAGA|TGGGACGCAGAGAGTCTAAGGTCTTGGAGT
TCAAGCACGCGTGCAGGCACGGAAGATCGC|GGAAAGGACAAATAAATTTCGTGCAGTGGT
GTAACAACGGTTCTGTTGAGACTCACTTCG|GGGACGCAGAGAGTCTAAGGTCTTGCGCAG
ATGAGGAAAGGACAAATAAATTTCGTGCAG|CTCCAGCCGAAATAGCTTACGGTTAACACC
CTGTTGAGACTCACTTCGCAACCTAGTCAG|GTCTAAGGTCTTGCGCAGAGAGTCTGTTTT
ACAACGGTTCTGTTGAGACTCACTTCGCAA|ACGCAGAGAGTCTAAGGTCTTGCGCAGAGA
CCAAAGGGGACTAGGCTCCGTCCGTTTTGG|GTCTAAGGTCTTGTCAAGCACGCGTGCAGG
GCCGAAGCGTGGTCTAGATAACATGCTACG|GGCGTAGGGGTTCATCGAAGGGTGATAGCT
CAGAGAGTCTAAGGTCTTGTCACATTACCC|TGAGGACTGCTAGTATGGCTCATCATAGCG
TCAAATATACAACAAAGCGAGCCAAAAGAG|CGTGGGGTGTGCACAACGTGATGCGAACCA
AATGATATTGGGCCTATACGCGGGCTTCAG|GATGGGGCAAGCGACTTAGCGAGTCTTCTG
TGCGCAGAGAGTCTGTTTTGGGACGCAGAG|GCCCTATACTAGGAAGGTTTTGGGACGCAG
AGAGTTTTGGGACGCAGAGAGTCTAAGGTC|CCAGAAGATTAAGACAAATCAAGGACGCGT
CTGCAAACTACTCAGGCCACGCGGTTATTC|GGACGCAGAGAGTCTAAGGTCTTGAAGGTC
CAGAGAGTCTAAGGTCTTGGAGTCTAAGGT|CAAATCAAGGACGCGTTTAAAGGCGCGCTT
GTACAGAACAATTGTAAAACGCAAGACTGC|CGCCCCAGGACCACAAAGAGCCCCTCGGCA
GAGAGTCTAAGGTCTTGGCCTATGGCGTGG|GAGTCTAAGGTCTTGGGGCGGCACTGCACA
GCAGGCACGGAAGATCGCGAAACAAAAGCA|TAAATTTCGTGCAGTGGTTCCAAGTATCAC
GCAGAGAGTCTAAGGTCTTGTCCCATTTGT|TCCGAACGTCAAATATACAACAAAGCGAGC
GAGAGTCTAAGGTCTTGGGACAGAGAATGA|GTCTAAGGTCTTGGAACTTCTCTAAGATGG
GGTACCTCCAGTAAGTTTGAAAGACGCCAC|GAAGCGTGGTCTAGATAACATGCTACGTTT
TGGGACGCAGAGAGTCTAAGGTCTTGGGGC|GGGCCCGGTACCTCCAGTAAGTTTGAAAGA
GGCCACGCGGTTATTCTCCAACGCCCCAGG|TAAGGTCTTGAAGGTCGTTTTGGGACGCAG
ACGCAGAGAGTCTAAGGTCTTGTCACATTA|AATTGAGGACTGCTAGTATGGCTCATCATA
AGAGTCTAAGGTCTTGTGTTTTGGGACGCA|TCTTGATACACAAACGTTTTGGGACGCAGA
GGTCTTGGCCTATGGCGTGGGGTGTGCACA|TCTTGGGGCGGCACTGCACAAGTGTGTTTT
TTTTGGGACGCAGAGAGTCTAAGGTCTTGG|TTGGGACGCAGAGAGTCTAAGGTCTTGGGG
AGTTTTGGGACGCAGAGAGTCTAAGGTCTT|AGAAGATTAAGACAAATCAAGGACGCGTTT
ACTAGGAAGGTTTTGGGACGCAGAGAGTCT|GCAGAGAGTCTAAGGTCTTGGAGTCTAAGG
AGGCCGAAGCGTGGTCTAGATAACATGCTA|AAGGCGTAGGGGTTCATCGAAGGGTGATAG
GACTGCACTGTAGATGACTAAGAGGAATGT|TCGGCAAAGCACTGGTTTTGGGAGTTTTGG
TCCAGTAAGTTTGAAAGACGCCACTTGACG|TGGTCTAGATAACATGCTACGTTTTGGGAC
AAGTCTATACAAGTTTTGGGACGCAGAGAG|CGTTTTGGGACGCAGAGAGTCTAAGGTCTT
TGAAACTCTAGCGAGACTGCTGCGCCAATG|CAGTTGCTGGCGGTAGCTGGAACGTCAAAG
GATGGGGCAAGCGACTTAGCGAGTCTTCTG|GTTTTGGGACGCAGAGAGTCTAAGGTCTTG
CGCAGAGTTTTGGGACGCAGAGAGTCTAAG|GTCCCAGAAGATTAAGACAAATCAAGGACG
AAGGTCTTGGCCTATGGCGTGGGGTGTGCA|GGTCTTGGGGCGGCACTGCACAAGTGTGTT
TTTTGGGACGCAGAGAGTCTAAGGTCTTGC|GGTCTTGTGTTTTGGGACGCAGAGAGTCTA
ACGCAAGACTGCACTGTAGATGACTAAGAG|AGCCCCTCGGCAAAGCACTGGTTTTGGGAG
GCGCAGAGAGTCTGTTTTGGGACGCAGAGA|CCCTATACTAGGAAGGTTTTGGGACGCAGA
ACTGCACTGTAGATGACTAAGAGGAATGTA|CGGCAAAGCACTGGTTTTGGGAGTTTTGGG
AGAGTCTAAGGTCTTGCAAGTAGTGTCCGA|GGGACGCAGAGAGTCTAAGGTCTTGGCCTA
GCGTTTAAAGGCGCGCTTTTAGCTCCTGCG|AAGTCTATACAAGTTTTGGGACGCAGAGAG
GGTTTTGGGACGCAGAGAGTCTAAGGTCTT|AAGGTCTTGTGTTTTGGGACGCAGAGAGTC
TGATACACAAACGTTTTGGGACGCAGAGAG|AGCATTGCACGTTCTCGGGCCCGGTACCTC
TAACATGCTACGTTTTGGGACGCAGAGAGT|AGGGTGATAGCTGGCCTGCAATTGAGGACT
AACGTTTTGGGACGCAGAGAGTCTAAGGTC|CGTTCTCGGGCCCGGTACCTCCAGTAAGTT
GAAACCCCGTGGACTTACTCCCCTGGTACA|CTCAGGCCACGCGGTTATTCTCCAACGCCC
GACGCAGAGAGTCTAAGGTCTTGGGACAGA|CTTGGAGTCTAAGGTCTTGGAACTTCTCTA
TTTGGGACGCAGAGAGTCTAAGGTCTTGTT|AGAATGATATTGGGCCTATACGCGGGCTTC
GATATTGGGCCTATACGCGGGCTTCAGTTG|GGGGCAAGCGACTTAGCGAGTCTTCTGTTT
GGGACTAGGCTCCGTCCGTTTTGGGACGCA|GGTCTTGTCAAGCACGCGTGCAGGCACGGA
GTTGGGTTTTGGGACGCAGAGAGTCTAAGG|GTCTAAGGTCTTGTGTTTTGGGACGCAGAG
GTTTTGGGACGCAGAGAGTCTAAGGTCTTG|AGGTTTTGGGACGCAGAGAGTCTAAGGTCT
ACGTTTTGGGACGCAGAGAGTCTAAGGTCT|GCTGGCCTGCAATTGAGGACTGCTAGTATG
GACGCCACTTGACGAAACACCTAAATTCCC|CTACGTTTTGGGACGCAGAGAGTCTAAGGT
TTGTAAAACGCAAGACTGCACTGTAGATGA|CACAAAGAGCCCCTCGGCAAAGCACTGGTT
GCGCCAATGGAGGCCTACCCGTCAAGGCGC|ACGTCAAAGGGTTTTGGGACGCAGAGTTTT
GTTTTGGGACGCAGAGAGTCTAAGGTCTTG|TCTCGGGCCCGGTACCTCCAGTAAGTTTGA
GGTCTTGTCACATTACCCTCCAGCCGAAAT|GTATGGCTCATCATAGCGGCAGAGAGCCAT
GATGACTAAGAGGAATGTAACAACGGTTCT|TGGTTTTGGGAGTTTTGGGACGCAGAGAGT
TGGAACTTCTCTAAGATGGGGCAAGCGACT|AGCTCCTGCGTTGGGTTTTGGGACGCAGAG
TTGCACGTTCTCGGGCCCGGTACCTCCAGT|GGGCTCAGGGGCGAGGCCGAAGCGTGGTCT
CCTCGGCAAAGCACTGGTTTTGGGAGTTTT|TTGTTGAAACTCTAGCGAGACTGCTGCGCC
GAAAGGACAAATAAATTTCGTGCAGTGGTT|GCCGAAATAGCTTACGGTTAACACCGCTCA
AAACGTTTTGGGACGCAGAGAGTCTAAGGT|ACGTTCTCGGGCCCGGTACCTCCAGTAAGT
GGGCCCGGTACCTCCAGTAAGTTTGAAAGA|GAGGCCGAAGCGTGGTCTAGATAACATGCT
AAGATGGGGCAAGCGACTTAGCGAGTCTTC|GGGTTTTGGGACGCAGAGAGTCTAAGGTCT
ACCTAAATTCCCAGACTCAGCGCTGCATGA|AGAGTCTAAGGTCTTGTCACATTACCCTCC
GTCTTGGAACTTCTCTAAGATGGGGCAAGC|TTTTAGCTCCTGCGTTGGGTTTTGGGACGC
GGGCTCAGGGGCGAGGCCGAAGCGTGGTCT|CCGATTGTCGCTCAAGGCGTAGGGGTTCAT
TTGCGCAGAGAGTCTGTTTTGGGACGCAGA|CGCCCTATACTAGGAAGGTTTTGGGACGCA
GTTTTGGGACGCAGAGAGTCTAAGGTCTTG|AGGTCTTGTGTTTTGGGACGCAGAGAGTCT
TGGGACGCAGAGAGTCTAAGGTCTTGCGCA|CAATGGAGGCCTACCCGTCAAGGCGCCCTA
AGCTCCTGCGTTGGGTTTTGGGACGCAGAG|ACGCAGAGAGTCTAAGGTCTTGTGTTTTGG
ACGCGGGCTTCAGTTGCTGGCGGTAGCTGG|AGCGAGTCTTCTGTTTTGGGACGCAGAGAG
TCTAAGGTCTTGAAGGTCGTTTTGGGACGC|AGTCTAAGGTCTTGGGACAGAGAATGATAT
GTCTAAGGTCTTGCAAGTAGTGTCCGAACG|ACGCAGAGAGTCTAAGGTCTTGGCCTATGG
CGCAGAGAGTCTAAGGTCTTGCGCAGAGAG|GAGGCCTACCCGTCAAGGCGCCCTATACTA
GTTTTGGGACGCAGAGAGTCTAAGGTCTTG|CTAAGGTCTTGGAGTCTAAGGTCTTGGAAC
TTTTGGGACGCAGAGTTTTGGGACGCAGAG|TCCCATTTGTCCCAGAAGATTAAGACAAAT
GTCTAGATAACATGCTACGTTTTGGGACGC|TCATCGAAGGGTGATAGCTGGCCTGCAATT
TGTAACAACGGTTCTGTTGAGACTCACTTC|TGGGACGCAGAGAGTCTAAGGTCTTGCGCA
GAGAGTCTAAGGTCTTGCGCAGAGAGTCTG|CCTACCCGTCAAGGCGCCCTATACTAGGAA
TCGGCAAAGCACTGGTTTTGGGAGTTTTGG|GTTGAAACTCTAGCGAGACTGCTGCGCCAA
AGAGAGTCTAAGGTCTTGTTGAAACTCTAG|TGGGCCTATACGCGGGCTTCAGTTGCTGGC
GCGCCCTATACTAGGAAGGTTTTGGGACGC|TTTTGGGACGCAGAGAGTCTAAGGTCTTGG
CGACTTAGCGAGTCTTCTGTTTTGGGACGC|CAGAGAGTCTAAGGTCTTGCAAGTAGTGTC
GGGGCGAGGCCGAAGCGTGGTCTAGATAAC|TCGCTCAAGGCGTAGGGGTTCATCGAAGGG
TAAGGTCTTGGCCTATGGCGTGGGGTGTGC|AGGTCTTGGGGCGGCACTGCACAAGTGTGT
CGCCAATGGAGGCCTACCCGTCAAGGCGCC|CGTCAAAGGGTTTTGGGACGCAGAGTTTTG
TGGGGCAAGCGACTTAGCGAGTCTTCTGTT|TTTGGGACGCAGAGAGTCTAAGGTCTTGCA
GCCCGGTACCTCCAGTAAGTTTGAAAGACG|GGCCGAAGCGTGGTCTAGATAACATGCTAC
CTTGGGACAGAGAATGATATTGGGCCTATA|GAACTTCTCTAAGATGGGGCAAGCGACTTA
TCTTGCGCAGAGAGTCTGTTTTGGGACGCA|GGCGCCCTATACTAGGAAGGTTTTGGGACG
AGGCACGGAAGATCGCGAAACAAAAGCATT|AATTTCGTGCAGTGGTTCCAAGTATCACGG
CTAAGGTCTTGGGACAGAGAATGATATTGG|GGTCTTGGAACTTCTCTAAGATGGGGCAAG
TAAGGTCTTGCGCAGAGAGTCTGTTTTGGG|GTCAAGGCGCCCTATACTAGGAAGGTTTTG
GTGATGCGAACCAAAGGGGACTAGGCTCCG|GACGCAGAGAGTCTAAGGTCTTGTCAAGCA
AGTCTAAGGTCTTGTCCCATTTGTCCCAGA|CGTCAAATATACAACAAAGCGAGCCAAAAG
ACGCAGAGAGTCTAAGGTCTTGAAGGTCGT|GGACGCAGAGAGTCTAAGGTCTTGGGACAG
CTCCAACGCCCCAGGACCACAAAGAGCCCC|CGTTTTGGGACGCAGAGAGTCTAAGGTCTT
TAAGTTTGAAAGACGCCACTTGACGAAACA|TAGATAACATGCTACGTTTTGGGACGCAGA
CTTGTCCCATTTGTCCCAGAAGATTAAGAC|ACAACAAAGCGAGCCAAAAGAGCGCAAAAC
AACGCCCCAGGACCACAAAGAGCCCCTCGG|TTGGGACGCAGAGAGTCTAAGGTCTTGTTG
TTTTGGGACGCAGAGAGTCTAAGGTCTTGG|TAAGGTCTTGGAGTCTAAGGTCTTGGAACT
CGAAACAAAAGCATTGCACGTTCTCGGGCC|TTCCAAGTATCACGGGCTCAGGGGCGAGGC
CTTGCAAGTAGTGTCCGAACGTCAAATATA|GTCTAAGGTCTTGGCCTATGGCGTGGGGTG
GCCTACCCGTCAAGGCGCCCTATACTAGGA|TTTGGGACGCAGAGTTTTGGGACGCAGAGA
AGTCTAAGGTCTTGTCAAGCACGCGTGCAG|TCAGCGCTGCATGAGGAAAGGACAAATAAA
GTACCTCCAGTAAGTTTGAAAGACGCCACT|AAGCGTGGTCTAGATAACATGCTACGTTTT
TGTTTTGGGACGCAGAGAGTCTAAGGTCTT|TGCAAGTAGTGTCCGAACGTCAAATATACA
AGAGTCTAAGGTCTTGCGCAGAGAGTCTGT|CTACCCGTCAAGGCGCCCTATACTAGGAAG
ACCCTGGTCATCAAAGTCTATACAAGTTTT|ACTAGGCTCCGTCCGTTTTGGGACGCAGAG
AGGTCTTGGAACTTCTCTAAGATGGGGCAA|GCTTTTAGCTCCTGCGTTGGGTTTTGGGAC
AACAAAAGCATTGCACGTTCTCGGGCCCGG|CAAGTATCACGGGCTCAGGGGCGAGGCCGA
GCTGGCGGTAGCTGGAACGTCAAAGGGTTT|TTGGGACGCAGAGAGTCTAAGGTCTTGTCC
TACAAGTTTTGGGACGCAGAGAGTCTAAGG|GGACGCAGAGAGTCTAAGGTCTTGATACAC
TGGCCTATGGCGTGGGGTGTGCACAACGTG|GGGCGGCACTGCACAAGTGTGTTTTGGGAC
TTTGGGACGCAGAGAGTCTAAGGTCTTGGG|TCGGGCCCGGTACCTCCAGTAAGTTTGAAA
ACGTCAAAGGGTTTTGGGACGCAGAGTTTT|CTAAGGTCTTGTCCCATTTGTCCCAGAAGA
AGAGAGTCTAAGGTCTTGTGTTTTGGGACG|GGTCTTGATACACAAACGTTTTGGGACGCA
ACAGAGAATGATATTGGGCCTATACGCGGG|CTCTAAGATGGGGCAAGCGACTTAGCGAGT
CTTGTCAAGCACGCGTGCAGGCACGGAAGA|ATGAGGAAAGGACAAATAAATTTCGTGCAG
AGGAATGTAACAACGGTTCTGTTGAGACTC|AGTTTTGGGACGCAGAGAGTCTAAGGTCTT
CTATACGCGGGCTTCAGTTGCTGGCGGTAG|ACTTAGCGAGTCTTCTGTTTTGGGACGCAG
TCAGCCTGCAAACTACTCAGGCCACGCGGT|TTTTGGGACGCAGAGAGTCTAAGGTCTTGA
AACCCCGTGGACTTACTCCCCTGGTACAGA|CAGGCCACGCGGTTATTCTCCAACGCCCCA
GGGACGCAGAGAGTCTAAGGTCTTGAAGGT|TTGGGACGCAGAGAGTCTAAGGTCTTGGGA
AAAGGCGCGCTTTTAGCTCCTGCGTTGGGT|ATACAAGTTTTGGGACGCAGAGAGTCTAAG
GGACAGAGAATGATATTGGGCCTATACGCG|TTCTCTAAGATGGGGCAAGCGACTTAGCGA
GTGTGCACAACGTGATGCGAACCAAAGGGG|GTGTGTTTTGGGACGCAGAGAGTCTAAGGT
TAAGGTCTTGGAACTTCTCTAAGATGGGGC|GCGCTTTTAGCTCCTGCGTTGGGTTTTGGG
AACCAAAGGGGACTAGGCTCCGTCCGTTTT|GAGTCTAAGGTCTTGTCAAGCACGCGTGCA
GTCCCATTTGTCCCAGAAGATTAAGACAAA|ACAAAGCGAGCCAAAAGAGCGCAAAACCCT
AAGATCGCGAAACAAAAGCATTGCACGTTC|GCAGTGGTTCCAAGTATCACGGGCTCAGGG
GAGTCTAAGGTCTTGGAGTCTAAGGTCTTG|TCAAGGACGCGTTTAAAGGCGCGCTTTTAG
GGTTCTGTTGAGACTCACTTCGCAACCTAG|GAGAGTCTAAGGTCTTGCGCAGAGAGTCTG
AACAAAGCGAGCCAAAAGAGCGCAAAACCC|GCACAACGTGATGCGAACCAAAGGGGACTA
CACTGCACAAGTGTGTTTTGGGACGCAGAG|CCACTTGACGAAACACCTAAATTCCCAGAC
CAACGCCCCAGGACCACAAAGAGCCCCTCG|TTTGGGACGCAGAGAGTCTAAGGTCTTGTT
AAAGGGGACTAGGCTCCGTCCGTTTTGGGA|CTAAGGTCTTGTCAAGCACGCGTGCAGGCA
AGTCTAAGGTCTTGGGGCGGCACTGCACAA|TCCAGTAAGTTTGAAAGACGCCACTTGACG
AGGACGCGTTTAAAGGCGCGCTTTTAGCTC|CATCAAAGTCTATACAAGTTTTGGGACGCA
GCGGTAGCTGGAACGTCAAAGGGTTTTGGG|GACGCAGAGAGTCTAAGGTCTTGTCCCATT
AGAGAGTCTAAGGTCTTGAAGGTCGTTTTG|GCAGAGAGTCTAAGGTCTTGGGACAGAGAA
ACACAAACGTTTTGGGACGCAGAGAGTCTA|TTGCACGTTCTCGGGCCCGGTACCTCCAGT
CAAGTATCACGGGCTCAGGGGCGAGGCCGA|TGAAAAGGTGCCGATTGTCGCTCAAGGCGT
GGTTCCAAGTATCACGGGCTCAGGGGCGAG|CTCAATGAAAAGGTGCCGATTGTCGCTCAA
GTCGTTTTGGGACGCAGAGAGTCTAAGGTC|GACAGAGAATGATATTGGGCCTATACGCGG
AACCCTGGTCATCAAAGTCTATACAAGTTT|GACTAGGCTCCGTCCGTTTTGGGACGCAGA
AAAGACGCCACTTGACGAAACACCTAAATT|ATGCTACGTTTTGGGACGCAGAGAGTCTAA
TAGTGTCCGAACGTCAAATATACAACAAAG|TCTTGGCCTATGGCGTGGGGTGTGCACAAC
GTCTTGTGTTTTGGGACGCAGAGAGTCTAA|CAAACGTTTTGGGACGCAGAGAGTCTAAGG
GGACGCAGAGAGTCTAAGGTCTTGAAGGTC|TGGGACGCAGAGAGTCTAAGGTCTTGGGAC
TGGGACGCAGAGAGTCTAAGGTCTTGGCCT|GGACGCAGAGAGTCTAAGGTCTTGGGGCGG
ACGCAGAGAGTCTAAGGTCTTGGGACAGAG|TTGGAGTCTAAGGTCTTGGAACTTCTCTAA
CCCATTTGTCCCAGAAGATTAAGACAAATC|AAAGCGAGCCAAAAGAGCGCAAAACCCTGG
ACCAATTAGGAAACCCCGTGGACTTACTCC|TGCAAACTACTCAGGCCACGCGGTTATTCT
TGTGCACAACGTGATGCGAACCAAAGGGGA|TGTGTTTTGGGACGCAGAGAGTCTAAGGTC
TAAGGTCTTGTGTTTTGGGACGCAGAGAGT|TACACAAACGTTTTGGGACGCAGAGAGTCT
AGGAAACCCCGTGGACTTACTCCCCTGGTA|TACTCAGGCCACGCGGTTATTCTCCAACGC
TGGAGTCTAAGGTCTTGGAACTTCTCTAAG|TAAAGGCGCGCTTTTAGCTCCTGCGTTGGG
TACTCAGGCCACGCGGTTATTCTCCAACGC|AGAGTCTAAGGTCTTGAAGGTCGTTTTGGG
CAGCGCTGCATGAGGAAAGGACAAATAAAT|CACATTACCCTCCAGCCGAAATAGCTTACG
TTTTGGGACGCAGAGAGTCTAAGGTCTTGT|AGAGAGTCTAAGGTCTTGATACACAAACGT
ATTGTAAAACGCAAGACTGCACTGTAGATG|CCACAAAGAGCCCCTCGGCAAAGCACTGGT
AAGGGTTTTGGGACGCAGAGTTTTGGGACG|TCTTGTCCCATTTGTCCCAGAAGATTAAGA
GCCACTTGACGAAACACCTAAATTCCCAGA|CGTTTTGGGACGCAGAGAGTCTAAGGTCTT
ACGCAGAGAGTCTAAGGTCTTGTGTTTTGG|CTAAGGTCTTGATACACAAACGTTTTGGGA
CAGGCCACGCGGTTATTCTCCAACGCCCCA|TCTAAGGTCTTGAAGGTCGTTTTGGGACGC
GCCAAAAGAGCGCAAAACCCTGGTCATCAA|ATGCGAACCAAAGGGGACTAGGCTCCGTCC
AAGGTCTTGTCAAGCACGCGTGCAGGCACG|GCTGCATGAGGAAAGGACAAATAAATTTCG
AGAGAATGATATTGGGCCTATACGCGGGCT|CTAAGATGGGGCAAGCGACTTAGCGAGTCT
GGGACGCAGAGTTTTGGGACGCAGAGAGTC|ATTTGTCCCAGAAGATTAAGACAAATCAAG
TTTTGGGACGCAGAGAGTCTAAGGTCTTGT|GGCCTGCAATTGAGGACTGCTAGTATGGCT
ATGCGAACCAAAGGGGACTAGGCTCCGTCC|GCAGAGAGTCTAAGGTCTTGTCAAGCACGC
GGACGCAGAGAGTCTAAGGTCTTGGAGTCT|TAAGACAAATCAAGGACGCGTTTAAAGGCG
CTTGTTGAAACTCTAGCGAGACTGCTGCGC|GGCTTCAGTTGCTGGCGGTAGCTGGAACGT
TGGGTTTTGGGACGCAGAGAGTCTAAGGTC|CTAAGGTCTTGTGTTTTGGGACGCAGAGAG
GGGACGCAGAGAGTCTAAGGTCTTGCGCAG|AATGGAGGCCTACCCGTCAAGGCGCCCTAT
TGGTTCCAAGTATCACGGGCTCAGGGGCGA|GCTCAATGAAAAGGTGCCGATTGTCGCTCA
AAACGCAAGACTGCACTGTAGATGACTAAG|AGAGCCCCTCGGCAAAGCACTGGTTTTGGG
GTCCGAACGTCAAATATACAACAAAGCGAG|GGCCTATGGCGTGGGGTGTGCACAACGTGA
CGTGCAGTGGTTCCAAGTATCACGGGCTCA|TAACACCGCTCAATGAAAAGGTGCCGATTG
TTCTCCAACGCCCCAGGACCACAAAGAGCC|GTCGTTTTGGGACGCAGAGAGTCTAAGGTC
AGCGCTGCATGAGGAAAGGACAAATAAATT|ACATTACCCTCCAGCCGAAATAGCTTACGG
GGACGCGTTTAAAGGCGCGCTTTTAGCTCC|ATCAAAGTCTATACAAGTTTTGGGACGCAG
GACAAATAAATTTCGTGCAGTGGTTCCAAG|AATAGCTTACGGTTAACACCGCTCAATGAA
GAGTCTAAGGTCTTGTTGAAACTCTAGCGA|GCCTATACGCGGGCTTCAGTTGCTGGCGGT
TGCATGAGGAAAGGACAAATAAATTTCGTG|ACCCTCCAGCCGAAATAGCTTACGGTTAAC
TGGGACGCAGAGAGTCTAAGGTCTTGTCAA|AAATTCCCAGACTCAGCGCTGCATGAGGAA
TTTGGGACGCAGAGAGTCTAAGGTCTTGCA|GTCTTGTGTTTTGGGACGCAGAGAGTCTAA
GACGAAACACCTAAATTCCCAGACTCAGCG|GGACGCAGAGAGTCTAAGGTCTTGTCACAT
GCAGAGAGTCTAAGGTCTTGTTGAAACTCT|ATTGGGCCTATACGCGGGCTTCAGTTGCTG
AGAGTCTAAGGTCTTGTCCCATTTGTCCCA|AACGTCAAATATACAACAAAGCGAGCCAAA
GTTGAGACTCACTTCGCAACCTAGTCAGCC|CTAAGGTCTTGCGCAGAGAGTCTGTTTTGG
TCTAAGGTCTTGGCCTATGGCGTGGGGTGT|TAAGGTCTTGGGGCGGCACTGCACAAGTGT
TTGGGACGCAGAGAGTCTAAGGTCTTGTCA|CCTGCAATTGAGGACTGCTAGTATGGCTCA
GCCTGCAAACTACTCAGGCCACGCGGTTAT|TGGGACGCAGAGAGTCTAAGGTCTTGAAGG
GAACGTCAAATATACAACAAAGCGAGCCAA|TATGGCGTGGGGTGTGCACAACGTGATGCG
AACGTCAAAGGGTTTTGGGACGCAGAGTTT|TCTAAGGTCTTGTCCCATTTGTCCCAGAAG
AACGCAAGACTGCACTGTAGATGACTAAGA|GAGCCCCTCGGCAAAGCACTGGTTTTGGGA
GGCGGTAGCTGGAACGTCAAAGGGTTTTGG|GGACGCAGAGAGTCTAAGGTCTTGTCCCAT
TCCGAACGTCAAATATACAACAAAGCGAGC|GCCTATGGCGTGGGGTGTGCACAACGTGAT
GACGCAGAGAGTCTAAGGTCTTGTCAAGCA|TTCCCAGACTCAGCGCTGCATGAGGAAAGG
CTAAGGTCTTGCGCAGAGAGTCTGTTTTGG|CGTCAAGGCGCCCTATACTAGGAAGGTTTT
GAGTTTTGGGACGCAGAGAGTCTAAGGTCT|CTGCGCCAATGGAGGCCTACCCGTCAAGGC
CACCTAAATTCCCAGACTCAGCGCTGCATG|GAGAGTCTAAGGTCTTGTCACATTACCCTC
TTGTGTTTTGGGACGCAGAGAGTCTAAGGT|ACGTTTTGGGACGCAGAGAGTCTAAGGTCT
AGTAAGTTTGAAAGACGCCACTTGACGAAA|TCTAGATAACATGCTACGTTTTGGGACGCA
CTTACTCCCCTGGTACAGAACAATTGTAAA|GTTATTCTCCAACGCCCCAGGACCACAAAG
TGGTTTTGGGAGTTTTGGGACGCAGAGAGT|GCGAGACTGCTGCGCCAATGGAGGCCTACC
TTGGGACGCAGAGAGTCTAAGGTCTTGATA|CAGGCACGGAAGATCGCGAAACAAAAGCAT
TCTAGCGAGACTGCTGCGCCAATGGAGGCC|CTGGCGGTAGCTGGAACGTCAAAGGGTTTT
AATTGTAAAACGCAAGACTGCACTGTAGAT|ACCACAAAGAGCCCCTCGGCAAAGCACTGG
CAAAGGGTTTTGGGACGCAGAGTTTTGGGA|GGTCTTGTCCCATTTGTCCCAGAAGATTAA
ATTACCCTCCAGCCGAAATAGCTTACGGTT|CATAGCGGCAGAGAGCCATAGGCGGAATAT
AGGGTTTTGGGACGCAGAGTTTTGGGACGC|CTTGTCCCATTTGTCCCAGAAGATTAAGAC
GCGTGCAGGCACGGAAGATCGCGAAACAAA|CAAATAAATTTCGTGCAGTGGTTCCAAGTA
TCGCAACCTAGTCAGCCTGCAAACTACTCA|CAGAGAGTCTGTTTTGGGACGCAGAGAGTC
CGGTTATTCTCCAACGCCCCAGGACCACAA|TTGAAGGTCGTTTTGGGACGCAGAGAGTCT
TTTCGTGCAGTGGTTCCAAGTATCACGGGC|GGTTAACACCGCTCAATGAAAAGGTGCCGA
CTTGCGCAGAGAGTCTGTTTTGGGACGCAG|GCGCCCTATACTAGGAAGGTTTTGGGACGC
AAAGCGAGCCAAAAGAGCGCAAAACCCTGG|CAACGTGATGCGAACCAAAGGGGACTAGGC
AAGCATTGCACGTTCTCGGGCCCGGTACCT|ATCACGGGCTCAGGGGCGAGGCCGAAGCGT
CGCAGAGAGTCTAAGGTCTTGTCAAGCACG|CCCAGACTCAGCGCTGCATGAGGAAAGGAC
CTGCACTGTAGATGACTAAGAGGAATGTAA|GGCAAAGCACTGGTTTTGGGAGTTTTGGGA
GGTCGTTTTGGGACGCAGAGAGTCTAAGGT|GGACAGAGAATGATATTGGGCCTATACGCG
ACTGTAGATGACTAAGAGGAATGTAACAAC|AAGCACTGGTTTTGGGAGTTTTGGGACGCA
AGAGTCTAAGGTCTTGTCAAGCACGCGTGC|ACTCAGCGCTGCATGAGGAAAGGACAAATA
ACTTGACGAAACACCTAAATTCCCAGACTC|TTTGGGACGCAGAGAGTCTAAGGTCTTGTC
CCACTTGACGAAACACCTAAATTCCCAGAC|GTTTTGGGACGCAGAGAGTCTAAGGTCTTG
GAGTCTAAGGTCTTGTCAAGCACGCGTGCA|CTCAGCGCTGCATGAGGAAAGGACAAATAA
GTGCAGTGGTTCCAAGTATCACGGGCTCAG|AACACCGCTCAATGAAAAGGTGCCGATTGT
GAGTCTAAGGTCTTGGGACAGAGAATGATA|CTAAGGTCTTGGAACTTCTCTAAGATGGGG
GGTCTTGTGTTTTGGGACGCAGAGAGTCTA|ACAAACGTTTTGGGACGCAGAGAGTCTAAG
AAGCGTGGTCTAGATAACATGCTACGTTTT|TAGGGGTTCATCGAAGGGTGATAGCTGGCC
CTAAGAGGAATGTAACAACGGTTCTGTTGA|TTGGGAGTTTTGGGACGCAGAGAGTCTAAG
AGCGACTTAGCGAGTCTTCTGTTTTGGGAC|CGCAGAGAGTCTAAGGTCTTGCAAGTAGTG
ACGCGTTTAAAGGCGCGCTTTTAGCTCCTG|CAAAGTCTATACAAGTTTTGGGACGCAGAG
AAGTTTGAAAGACGCCACTTGACGAAACAC|AGATAACATGCTACGTTTTGGGACGCAGAG
ATATTGGGCCTATACGCGGGCTTCAGTTGC|GGGCAAGCGACTTAGCGAGTCTTCTGTTTT
TCTTGGGGCGGCACTGCACAAGTGTGTTTT|TTTGAAAGACGCCACTTGACGAAACACCTA
GGCCCGGTACCTCCAGTAAGTTTGAAAGAC|AGGCCGAAGCGTGGTCTAGATAACATGCTA
CGTCAAAGGGTTTTGGGACGCAGAGTTTTG|TAAGGTCTTGTCCCATTTGTCCCAGAAGAT
GGGACGCAGAGAGTCTAAGGTCTTGGCCTA|GACGCAGAGAGTCTAAGGTCTTGGGGCGGC
ACAATTGTAAAACGCAAGACTGCACTGTAG|GGACCACAAAGAGCCCCTCGGCAAAGCACT
AAGGTCTTGTGTTTTGGGACGCAGAGAGTC|ACACAAACGTTTTGGGACGCAGAGAGTCTA
TCTGTTGAGACTCACTTCGCAACCTAGTCA|AGTCTAAGGTCTTGCGCAGAGAGTCTGTTT
TCATCAAAGTCTATACAAGTTTTGGGACGC|TCCGTCCGTTTTGGGACGCAGAGAGTCTAA
GCACTGCACAAGTGTGTTTTGGGACGCAGA|GCCACTTGACGAAACACCTAAATTCCCAGA
CGCAGAGAGTCTAAGGTCTTGTTGAAACTC|TATTGGGCCTATACGCGGGCTTCAGTTGCT
AAGGCGCCCTATACTAGGAAGGTTTTGGGA|GAGTTTTGGGACGCAGAGAGTCTAAGGTCT
TTGGGACGCAGAGTTTTGGGACGCAGAGAG|CCATTTGTCCCAGAAGATTAAGACAAATCA
GGTCTTGATACACAAACGTTTTGGGACGCA|ACAAAAGCATTGCACGTTCTCGGGCCCGGT
GGAAAGGACAAATAAATTTCGTGCAGTGGT|AGCCGAAATAGCTTACGGTTAACACCGCTC
GTCTAAGGTCTTGTTGAAACTCTAGCGAGA|CTATACGCGGGCTTCAGTTGCTGGCGGTAG
ATTTCGTGCAGTGGTTCCAAGTATCACGGG|CGGTTAACACCGCTCAATGAAAAGGTGCCG
TAAGGTCTTGATACACAAACGTTTTGGGAC|GAAACAAAAGCATTGCACGTTCTCGGGCCC
GTCTTGTCAAGCACGCGTGCAGGCACGGAA|GCATGAGGAAAGGACAAATAAATTTCGTGC
ACGCCACTTGACGAAACACCTAAATTCCCA|TACGTTTTGGGACGCAGAGAGTCTAAGGTC
AGACAAATCAAGGACGCGTTTAAAGGCGCG|AAACCCTGGTCATCAAAGTCTATACAAGTT
CTTAGCGAGTCTTCTGTTTTGGGACGCAGA|AGAGTCTAAGGTCTTGCAAGTAGTGTCCGA
ACCTAGTCAGCCTGCAAACTACTCAGGCCA|AGTCTGTTTTGGGACGCAGAGAGTCTAAGG
TCTTGGAACTTCTCTAAGATGGGGCAAGCG|TTTAGCTCCTGCGTTGGGTTTTGGGACGCA
CTCACTTCGCAACCTAGTCAGCCTGCAAAC|CTTGCGCAGAGAGTCTGTTTTGGGACGCAG
TTGGGTTTTGGGACGCAGAGAGTCTAAGGT|TCTAAGGTCTTGTGTTTTGGGACGCAGAGA
TCGCGAAACAAAAGCATTGCACGTTCTCGG|TGGTTCCAAGTATCACGGGCTCAGGGGCGA
GACGCAGAGAGTCTAAGGTCTTGTCCCATT|GTGTCCGAACGTCAAATATACAACAAAGCG
TCAAGGACGCGTTTAAAGGCGCGCTTTTAG|GGTCATCAAAGTCTATACAAGTTTTGGGAC
CCTGGTACAGAACAATTGTAAAACGCAAGA|CCAACGCCCCAGGACCACAAAGAGCCCCTC
CTTGAAGGTCGTTTTGGGACGCAGAGAGTC|GTCTTGGGACAGAGAATGATATTGGGCCTA
AGAGTCTAAGGTCTTGATACACAAACGTTT|GATCGCGAAACAAAAGCATTGCACGTTCTC
GGAATGTAACAACGGTTCTGTTGAGACTCA|GTTTTGGGACGCAGAGAGTCTAAGGTCTTG
TCGTTTTGGGACGCAGAGAGTCTAAGGTCT|ACAGAGAATGATATTGGGCCTATACGCGGG
AAGGACAAATAAATTTCGTGCAGTGGTTCC|CGAAATAGCTTACGGTTAACACCGCTCAAT
GTGCACAACGTGATGCGAACCAAAGGGGAC|GTGTTTTGGGACGCAGAGAGTCTAAGGTCT
CTGCGCCAATGGAGGCCTACCCGTCAAGGC|GAACGTCAAAGGGTTTTGGGACGCAGAGTT
GCCCCTCGGCAAAGCACTGGTTTTGGGAGT|GTCTTGTTGAAACTCTAGCGAGACTGCTGC
AAATCAAGGACGCGTTTAAAGGCGCGCTTT|CCTGGTCATCAAAGTCTATACAAGTTTTGG
CTGTTTTGGGACGCAGAGAGTCTAAGGTCT|GAAGGTTTTGGGACGCAGAGAGTCTAAGGT
GCAAGCGACTTAGCGAGTCTTCTGTTTTGG|GGACGCAGAGAGTCTAAGGTCTTGCAAGTA
GATAACATGCTACGTTTTGGGACGCAGAGA|GAAGGGTGATAGCTGGCCTGCAATTGAGGA
CTAGTCAGCCTGCAAACTACTCAGGCCACG|TCTGTTTTGGGACGCAGAGAGTCTAAGGTC
GATGCGAACCAAAGGGGACTAGGCTCCGTC|CGCAGAGAGTCTAAGGTCTTGTCAAGCACG
TGAGACTCACTTCGCAACCTAGTCAGCCTG|AAGGTCTTGCGCAGAGAGTCTGTTTTGGGA
GAGGCCTACCCGTCAAGGCGCCCTATACTA|GGTTTTGGGACGCAGAGTTTTGGGACGCAG
GTGGTTCCAAGTATCACGGGCTCAGGGGCG|CGCTCAATGAAAAGGTGCCGATTGTCGCTC
TGACGAAACACCTAAATTCCCAGACTCAGC|GGGACGCAGAGAGTCTAAGGTCTTGTCACA
GGAACTTCTCTAAGATGGGGCAAGCGACTT|GCTCCTGCGTTGGGTTTTGGGACGCAGAGA
ATACTAGGAAGGTTTTGGGACGCAGAGAGT|ACGCAGAGAGTCTAAGGTCTTGGAGTCTAA
TACCCGTCAAGGCGCCCTATACTAGGAAGG|GGGACGCAGAGTTTTGGGACGCAGAGAGTC
AGTCTAAGGTCTTGAAGGTCGTTTTGGGAC|AGAGTCTAAGGTCTTGGGACAGAGAATGAT
TTTGGGACGCAGAGAGTCTAAGGTCTTGGG|AAGGTCTTGGAGTCTAAGGTCTTGGAACTT
CTAAGATGGGGCAAGCGACTTAGCGAGTCT|TTGGGTTTTGGGACGCAGAGAGTCTAAGGT
AAGATTAAGACAAATCAAGGACGCGTTTAA|GAGCGCAAAACCCTGGTCATCAAAGTCTAT
GTTTAAAGGCGCGCTTTTAGCTCCTGCGTT|GTCTATACAAGTTTTGGGACGCAGAGAGTC
CGGAAGATCGCGAAACAAAAGCATTGCACG|CGTGCAGTGGTTCCAAGTATCACGGGCTCA
CTTGATACACAAACGTTTTGGGACGCAGAG|AAAGCATTGCACGTTCTCGGGCCCGGTACC
ACGCAGAGAGTCTAAGGTCTTGGAGTCTAA|AGACAAATCAAGGACGCGTTTAAAGGCGCG
CACAAACGTTTTGGGACGCAGAGAGTCTAA|TGCACGTTCTCGGGCCCGGTACCTCCAGTA
AGACTGCACTGTAGATGACTAAGAGGAATG|CTCGGCAAAGCACTGGTTTTGGGAGTTTTG
TTAAAGGCGCGCTTTTAGCTCCTGCGTTGG|CTATACAAGTTTTGGGACGCAGAGAGTCTA
TTGGGCCTATACGCGGGCTTCAGTTGCTGG|CAAGCGACTTAGCGAGTCTTCTGTTTTGGG
CCCCAGGACCACAAAGAGCCCCTCGGCAAA|GACGCAGAGAGTCTAAGGTCTTGTTGAAAC
TAAGAGGAATGTAACAACGGTTCTGTTGAG|TGGGAGTTTTGGGACGCAGAGAGTCTAAGG
AATTTCGTGCAGTGGTTCCAAGTATCACGG|ACGGTTAACACCGCTCAATGAAAAGGTGCC
CTTGGCCTATGGCGTGGGGTGTGCACAACG|TGGGGCGGCACTGCACAAGTGTGTTTTGGG
TAAATTTCGTGCAGTGGTTCCAAGTATCAC|TTACGGTTAACACCGCTCAATGAAAAGGTG
CGCAGAGAGTCTAAGGTCTTGTGTTTTGGG|TAAGGTCTTGATACACAAACGTTTTGGGAC
TGAGGAAAGGACAAATAAATTTCGTGCAGT|TCCAGCCGAAATAGCTTACGGTTAACACCG
ACGCAGAGTTTTGGGACGCAGAGAGTCTAA|TGTCCCAGAAGATTAAGACAAATCAAGGAC
TGTAAAACGCAAGACTGCACTGTAGATGAC|ACAAAGAGCCCCTCGGCAAAGCACTGGTTT
ACTACTCAGGCCACGCGGTTATTCTCCAAC|AGAGAGTCTAAGGTCTTGAAGGTCGTTTTG
GAATGATATTGGGCCTATACGCGGGCTTCA|AGATGGGGCAAGCGACTTAGCGAGTCTTCT
TCTTGATACACAAACGTTTTGGGACGCAGA|AAAAGCATTGCACGTTCTCGGGCCCGGTAC
AGACTCACTTCGCAACCTAGTCAGCCTGCA|GGTCTTGCGCAGAGAGTCTGTTTTGGGACG
CAGAGAGTCTAAGGTCTTGTCAAGCACGCG|CAGACTCAGCGCTGCATGAGGAAAGGACAA
TCTTGTCAAGCACGCGTGCAGGCACGGAAG|CATGAGGAAAGGACAAATAAATTTCGTGCA
AAGAGCCCCTCGGCAAAGCACTGGTTTTGG|TAAGGTCTTGTTGAAACTCTAGCGAGACTG
GGGGACTAGGCTCCGTCCGTTTTGGGACGC|AGGTCTTGTCAAGCACGCGTGCAGGCACGG
AAAGTCTATACAAGTTTTGGGACGCAGAGA|CCGTTTTGGGACGCAGAGAGTCTAAGGTCT
TTGGGACGCAGAGAGTCTAAGGTCTTGTCC|AGTAGTGTCCGAACGTCAAATATACAACAA
AAGTAGTGTCCGAACGTCAAATATACAACA|AGGTCTTGGCCTATGGCGTGGGGTGTGCAC
TGATATTGGGCCTATACGCGGGCTTCAGTT|TGGGGCAAGCGACTTAGCGAGTCTTCTGTT
TCTATACAAGTTTTGGGACGCAGAGAGTCT|TTTGGGACGCAGAGAGTCTAAGGTCTTGAT
AGTTTGAAAGACGCCACTTGACGAAACACC|GATAACATGCTACGTTTTGGGACGCAGAGA
AGACTCAGCGCTGCATGAGGAAAGGACAAA|CTTGTCACATTACCCTCCAGCCGAAATAGC
CGCAACCTAGTCAGCCTGCAAACTACTCAG|AGAGAGTCTGTTTTGGGACGCAGAGAGTCT
CTCCCCTGGTACAGAACAATTGTAAAACGC|TTCTCCAACGCCCCAGGACCACAAAGAGCC
CTAAGGTCTTGGAGTCTAAGGTCTTGGAAC|GGACGCGTTTAAAGGCGCGCTTTTAGCTCC
CAGAACAATTGTAAAACGCAAGACTGCACT|CCCAGGACCACAAAGAGCCCCTCGGCAAAG
AGGACCACAAAGAGCCCCTCGGCAAAGCAC|CAGAGAGTCTAAGGTCTTGTTGAAACTCTA
CAGAGAGTCTAAGGTCTTGGCCTATGGCGT|GAGAGTCTAAGGTCTTGGGGCGGCACTGCA
AACACCTAAATTCCCAGACTCAGCGCTGCA|CAGAGAGTCTAAGGTCTTGTCACATTACCC
GCTTTTAGCTCCTGCGTTGGGTTTTGGGAC|TTTGGGACGCAGAGAGTCTAAGGTCTTGTG
TAGCTGGAACGTCAAAGGGTTTTGGGACGC|CAGAGAGTCTAAGGTCTTGTCCCATTTGTC
TCCCAGAAGATTAAGACAAATCAAGGACGC|CCAAAAGAGCGCAAAACCCTGGTCATCAAA
CACCAATTAGGAAACCCCGTGGACTTACTC|CTGCAAACTACTCAGGCCACGCGGTTATTC
CCCGTGGACTTACTCCCCTGGTACAGAACA|GCCACGCGGTTATTCTCCAACGCCCCAGGA
GAGAGTCTAAGGTCTTGAAGGTCGTTTTGG|CAGAGAGTCTAAGGTCTTGGGACAGAGAAT
AAGACAAATCAAGGACGCGTTTAAAGGCGC|AAAACCCTGGTCATCAAAGTCTATACAAGT
CGTCAAATATACAACAAAGCGAGCCAAAAG|GGCGTGGGGTGTGCACAACGTGATGCGAAC
AGTATCACGGGCTCAGGGGCGAGGCCGAAG|AAAAGGTGCCGATTGTCGCTCAAGGCGTAG
GTGCAGGCACGGAAGATCGCGAAACAAAAG|AATAAATTTCGTGCAGTGGTTCCAAGTATC
CCAATGGAGGCCTACCCGTCAAGGCGCCCT|TCAAAGGGTTTTGGGACGCAGAGTTTTGGG
CTATACAAGTTTTGGGACGCAGAGAGTCTA|TTGGGACGCAGAGAGTCTAAGGTCTTGATA
TTACTCCCCTGGTACAGAACAATTGTAAAA|TTATTCTCCAACGCCCCAGGACCACAAAGA
GACGCAGAGAGTCTAAGGTCTTGTCACATT|CAATTGAGGACTGCTAGTATGGCTCATCAT
GCATTGCACGTTCTCGGGCCCGGTACCTCC|CACGGGCTCAGGGGCGAGGCCGAAGCGTGG
GGTTTTGGGACGCAGAGAGTCTAAGGTCTT|TCTAAGGTCTTGGAGTCTAAGGTCTTGGAA
CGTTTTGGGACGCAGAGAGTCTAAGGTCTT|CGTGCAGGCACGGAAGATCGCGAAACAAAA
ACTAGGCTCCGTCCGTTTTGGGACGCAGAG|CTTGTCAAGCACGCGTGCAGGCACGGAAGA
CAAAGCACTGGTTTTGGGAGTTTTGGGACG|AAACTCTAGCGAGACTGCTGCGCCAATGGA
AGTCTGTTTTGGGACGCAGAGAGTCTAAGG|TAGGAAGGTTTTGGGACGCAGAGAGTCTAA
AACTTCTCTAAGATGGGGCAAGCGACTTAG|TCCTGCGTTGGGTTTTGGGACGCAGAGAGT
AAGGTCTTGTCACATTACCCTCCAGCCGAA|TAGTATGGCTCATCATAGCGGCAGAGAGCC
ACAACGTGATGCGAACCAAAGGGGACTAGG|TTTGGGACGCAGAGAGTCTAAGGTCTTGTC
GTCTAAGGTCTTGTCCCATTTGTCCCAGAA|GTCAAATATACAACAAAGCGAGCCAAAAGA
TGTAGATGACTAAGAGGAATGTAACAACGG|GCACTGGTTTTGGGAGTTTTGGGACGCAGA
GAACTTCTCTAAGATGGGGCAAGCGACTTA|CTCCTGCGTTGGGTTTTGGGACGCAGAGAG
TTGGCCTATGGCGTGGGGTGTGCACAACGT|GGGGCGGCACTGCACAAGTGTGTTTTGGGA
CTTGTGTTTTGGGACGCAGAGAGTCTAAGG|AACGTTTTGGGACGCAGAGAGTCTAAGGTC
AAAGCATTGCACGTTCTCGGGCCCGGTACC|TATCACGGGCTCAGGGGCGAGGCCGAAGCG
ATATACAACAAAGCGAGCCAAAAGAGCGCA|GGGTGTGCACAACGTGATGCGAACCAAAGG
TAAGGTCTTGTCACATTACCCTCCAGCCGA|CTAGTATGGCTCATCATAGCGGCAGAGAGC
GAGTTTTGGGACGCAGAGAGTCTAAGGTCT|CAGAAGATTAAGACAAATCAAGGACGCGTT
GCAAACTACTCAGGCCACGCGGTTATTCTC|ACGCAGAGAGTCTAAGGTCTTGAAGGTCGT
GGGCGAGGCCGAAGCGTGGTCTAGATAACA|CGCTCAAGGCGTAGGGGTTCATCGAAGGGT
TTGGGACGCAGAGAGTCTAAGGTCTTGGAG|GATTAAGACAAATCAAGGACGCGTTTAAAG
CCGTGGACTTACTCCCCTGGTACAGAACAA|CCACGCGGTTATTCTCCAACGCCCCAGGAC
ATGGAGGCCTACCCGTCAAGGCGCCCTATA|AAGGGTTTTGGGACGCAGAGTTTTGGGACG
GCCAATGGAGGCCTACCCGTCAAGGCGCCC|GTCAAAGGGTTTTGGGACGCAGAGTTTTGG
TCTCCAACGCCCCAGGACCACAAAGAGCCC|TCGTTTTGGGACGCAGAGAGTCTAAGGTCT
CGGCAAAGCACTGGTTTTGGGAGTTTTGGG|TTGAAACTCTAGCGAGACTGCTGCGCCAAT
CAAAACCCTGGTCATCAAAGTCTATACAAG|GGGGACTAGGCTCCGTCCGTTTTGGGACGC
CGCAGAGAGTCTAAGGTCTTGGGACAGAGA|TGGAGTCTAAGGTCTTGGAACTTCTCTAAG
CTAAGGTCTTGCAAGTAGTGTCCGAACGTC|GCAGAGAGTCTAAGGTCTTGGCCTATGGCG
ACGCAGAGAGTCTAAGGTCTTGTCAAGCAC|TCCCAGACTCAGCGCTGCATGAGGAAAGGA
TCAGCGCTGCATGAGGAAAGGACAAATAAA|TCACATTACCCTCCAGCCGAAATAGCTTAC
AAACTCTAGCGAGACTGCTGCGCCAATGGA|GTTGCTGGCGGTAGCTGGAACGTCAAAGGG
TACAACAAAGCGAGCCAAAAGAGCGCAAAA|TGTGCACAACGTGATGCGAACCAAAGGGGA
AGCCTGCAAACTACTCAGGCCACGCGGTTA|TTGGGACGCAGAGAGTCTAAGGTCTTGAAG
GGGACGCAGAGAGTCTAAGGTCTTGCAAGT|TTGTGTTTTGGGACGCAGAGAGTCTAAGGT
ACCCTCCAGCCGAAATAGCTTACGGTTAAC|AGCGGCAGAGAGCCATAGGCGGAATATAAT
CCTGCAAACTACTCAGGCCACGCGGTTATT|GGGACGCAGAGAGTCTAAGGTCTTGAAGGT
CTCTAAGATGGGGCAAGCGACTTAGCGAGT|CGTTGGGTTTTGGGACGCAGAGAGTCTAAG
GGGACAGAGAATGATATTGGGCCTATACGC|CTTCTCTAAGATGGGGCAAGCGACTTAGCG
GACTAAGAGGAATGTAACAACGGTTCTGTT|TTTTGGGAGTTTTGGGACGCAGAGAGTCTA
TGTCCGAACGTCAAATATACAACAAAGCGA|TGGCCTATGGCGTGGGGTGTGCACAACGTG
TAGGAAACCCCGTGGACTTACTCCCCTGGT|CTACTCAGGCCACGCGGTTATTCTCCAACG
TTAGCTCCTGCGTTGGGTTTTGGGACGCAG|GGACGCAGAGAGTCTAAGGTCTTGTGTTTT
CGGGCCCGGTACCTCCAGTAAGTTTGAAAG|CGAGGCCGAAGCGTGGTCTAGATAACATGC
CTCAGGGGCGAGGCCGAAGCGTGGTCTAGA|ATTGTCGCTCAAGGCGTAGGGGTTCATCGA
AATCAAGGACGCGTTTAAAGGCGCGCTTTT|CTGGTCATCAAAGTCTATACAAGTTTTGGG
GGGACGCAGAGAGTCTAAGGTCTTGTCCCA|TAGTGTCCGAACGTCAAATATACAACAAAG
TTCGCAACCTAGTCAGCCTGCAAACTACTC|GCAGAGAGTCTGTTTTGGGACGCAGAGAGT
CACGGAAGATCGCGAAACAAAAGCATTGCA|TTCGTGCAGTGGTTCCAAGTATCACGGGCT
GCACTGGTTTTGGGAGTTTTGGGACGCAGA|TCTAGCGAGACTGCTGCGCCAATGGAGGCC
CAACGGTTCTGTTGAGACTCACTTCGCAAC|CGCAGAGAGTCTAAGGTCTTGCGCAGAGAG
GGTCTAGATAACATGCTACGTTTTGGGACG|TTCATCGAAGGGTGATAGCTGGCCTGCAAT
GGGCCTATACGCGGGCTTCAGTTGCTGGCG|AGCGACTTAGCGAGTCTTCTGTTTTGGGAC
GAGACTGCTGCGCCAATGGAGGCCTACCCG|GTAGCTGGAACGTCAAAGGGTTTTGGGACG
GACGCAGAGAGTCTAAGGTCTTGGAGTCTA|AAGACAAATCAAGGACGCGTTTAAAGGCGC
AGACTGCTGCGCCAATGGAGGCCTACCCGT|TAGCTGGAACGTCAAAGGGTTTTGGGACGC
AGAGAGTCTAAGGTCTTGGCCTATGGCGTG|AGAGTCTAAGGTCTTGGGGCGGCACTGCAC
TCTAAGGTCTTGGGACAGAGAATGATATTG|AGGTCTTGGAACTTCTCTAAGATGGGGCAA
CGTGGACTTACTCCCCTGGTACAGAACAAT|CACGCGGTTATTCTCCAACGCCCCAGGACC
CGCAAAACCCTGGTCATCAAAGTCTATACA|AAGGGGACTAGGCTCCGTCCGTTTTGGGAC
TCACCAATTAGGAAACCCCGTGGACTTACT|CCTGCAAACTACTCAGGCCACGCGGTTATT
TAAGATGGGGCAAGCGACTTAGCGAGTCTT|TGGGTTTTGGGACGCAGAGAGTCTAAGGTC
CAGGCACGGAAGATCGCGAAACAAAAGCAT|AAATTTCGTGCAGTGGTTCCAAGTATCACG
ACTTAGCGAGTCTTCTGTTTTGGGACGCAG|GAGAGTCTAAGGTCTTGCAAGTAGTGTCCG
TACACAAACGTTTTGGGACGCAGAGAGTCT|ATTGCACGTTCTCGGGCCCGGTACCTCCAG
GCAGAGAGTCTAAGGTCTTGCAAGTAGTGT|TTTTGGGACGCAGAGAGTCTAAGGTCTTGG
GTCAAATATACAACAAAGCGAGCCAAAAGA|GCGTGGGGTGTGCACAACGTGATGCGAACC
TCTCGGGCCCGGTACCTCCAGTAAGTTTGA|GGGCGAGGCCGAAGCGTGGTCTAGATAACA
CTCCAGCCGAAATAGCTTACGGTTAACACC|GGCAGAGAGCCATAGGCGGAATATAATGGT
GACGCGTTTAAAGGCGCGCTTTTAGCTCCT|TCAAAGTCTATACAAGTTTTGGGACGCAGA
ATCACCAATTAGGAAACCCCGTGGACTTAC|GCCTGCAAACTACTCAGGCCACGCGGTTAT
CAGAGAGTCTAAGGTCTTGTCCCATTTGTC|CCGAACGTCAAATATACAACAAAGCGAGCC
TAAGGTCTTGGAGTCTAAGGTCTTGGAACT|GACGCGTTTAAAGGCGCGCTTTTAGCTCCT
AAAGGACAAATAAATTTCGTGCAGTGGTTC|CCGAAATAGCTTACGGTTAACACCGCTCAA
GGACGCAGAGAGTCTAAGGTCTTGTTGAAA|TGATATTGGGCCTATACGCGGGCTTCAGTT
CATTACCCTCCAGCCGAAATAGCTTACGGT|TCATAGCGGCAGAGAGCCATAGGCGGAATA
TCTAAGATGGGGCAAGCGACTTAGCGAGTC|GTTGGGTTTTGGGACGCAGAGAGTCTAAGG
ACCCCGTGGACTTACTCCCCTGGTACAGAA|AGGCCACGCGGTTATTCTCCAACGCCCCAG
AGCGAGTCTTCTGTTTTGGGACGCAGAGAG|GTCTAAGGTCTTGCAAGTAGTGTCCGAACG
TAAGGTCTTGAAGGTCGTTTTGGGACGCAG|TCTAAGGTCTTGGGACAGAGAATGATATTG
GGGACGCAGAGAGTCTAAGGTCTTGTCAAG|AATTCCCAGACTCAGCGCTGCATGAGGAAA
GACCACAAAGAGCCCCTCGGCAAAGCACTG|GAGAGTCTAAGGTCTTGTTGAAACTCTAGC
GACAGAGAATGATATTGGGCCTATACGCGG|TCTCTAAGATGGGGCAAGCGACTTAGCGAG
AGAGCGCAAAACCCTGGTCATCAAAGTCTA|ACCAAAGGGGACTAGGCTCCGTCCGTTTTG
GCACAACGTGATGCGAACCAAAGGGGACTA|GTTTTGGGACGCAGAGAGTCTAAGGTCTTG
TACGCGGGCTTCAGTTGCTGGCGGTAGCTG|TAGCGAGTCTTCTGTTTTGGGACGCAGAGA
AGTCTAAGGTCTTGATACACAAACGTTTTG|TCGCGAAACAAAAGCATTGCACGTTCTCGG
TCCCAGACTCAGCGCTGCATGAGGAAAGGA|AGGTCTTGTCACATTACCCTCCAGCCGAAA
TGCAGTGGTTCCAAGTATCACGGGCTCAGG|ACACCGCTCAATGAAAAGGTGCCGATTGTC
GTCTAAGGTCTTGTCACATTACCCTCCAGC|CTGCTAGTATGGCTCATCATAGCGGCAGAG
CCTACCCGTCAAGGCGCCCTATACTAGGAA|TTGGGACGCAGAGTTTTGGGACGCAGAGAG
GGAAGGTTTTGGGACGCAGAGAGTCTAAGG|AGAGTCTAAGGTCTTGGAGTCTAAGGTCTT
AAAGAGCGCAAAACCCTGGTCATCAAAGTC|GAACCAAAGGGGACTAGGCTCCGTCCGTTT
CATCAAAGTCTATACAAGTTTTGGGACGCA|CCGTCCGTTTTGGGACGCAGAGAGTCTAAG
GTTCTGTTGAGACTCACTTCGCAACCTAGT|AGAGTCTAAGGTCTTGCGCAGAGAGTCTGT
TCTTGTCCCATTTGTCCCAGAAGATTAAGA|TACAACAAAGCGAGCCAAAAGAGCGCAAAA
AGTGTCCGAACGTCAAATATACAACAAAGC|CTTGGCCTATGGCGTGGGGTGTGCACAACG
TTTGGGACGCAGAGAGTCTAAGGTCTTGCG|GCCAATGGAGGCCTACCCGTCAAGGCGCCC
AGGTCTTGGCCTATGGCGTGGGGTGTGCAC|GTCTTGGGGCGGCACTGCACAAGTGTGTTT
TCACATTACCCTCCAGCCGAAATAGCTTAC|TCATCATAGCGGCAGAGAGCCATAGGCGGA
GAGAGTCTAAGGTCTTGCAAGTAGTGTCCG|TGGGACGCAGAGAGTCTAAGGTCTTGGCCT
CCTATACGCGGGCTTCAGTTGCTGGCGGTA|GACTTAGCGAGTCTTCTGTTTTGGGACGCA
CAAGTAGTGTCCGAACGTCAAATATACAAC|AAGGTCTTGGCCTATGGCGTGGGGTGTGCA
GTTGAAACTCTAGCGAGACTGCTGCGCCAA|TTCAGTTGCTGGCGGTAGCTGGAACGTCAA
TGGGGCGGCACTGCACAAGTGTGTTTTGGG|GAAAGACGCCACTTGACGAAACACCTAAAT
GCGGCACTGCACAAGTGTGTTTTGGGACGC|GACGCCACTTGACGAAACACCTAAATTCCC
CTCCGTCCGTTTTGGGACGCAGAGAGTCTA|AAGCACGCGTGCAGGCACGGAAGATCGCGA
ACTCCCCTGGTACAGAACAATTGTAAAACG|ATTCTCCAACGCCCCAGGACCACAAAGAGC
GAGTCTAAGGTCTTGCGCAGAGAGTCTGTT|TACCCGTCAAGGCGCCCTATACTAGGAAGG
AGGAAAGGACAAATAAATTTCGTGCAGTGG|CAGCCGAAATAGCTTACGGTTAACACCGCT
GATACACAAACGTTTTGGGACGCAGAGAGT|GCATTGCACGTTCTCGGGCCCGGTACCTCC
AACGTGATGCGAACCAAAGGGGACTAGGCT|TGGGACGCAGAGAGTCTAAGGTCTTGTCAA
ATCAAAGTCTATACAAGTTTTGGGACGCAG|CGTCCGTTTTGGGACGCAGAGAGTCTAAGG
ACATTACCCTCCAGCCGAAATAGCTTACGG|ATCATAGCGGCAGAGAGCCATAGGCGGAAT
TTAGGAAACCCCGTGGACTTACTCCCCTGG|ACTACTCAGGCCACGCGGTTATTCTCCAAC
GTGGTCTAGATAACATGCTACGTTTTGGGA|GGTTCATCGAAGGGTGATAGCTGGCCTGCA
AAGGTCTTGTTGAAACTCTAGCGAGACTGC|ACGCGGGCTTCAGTTGCTGGCGGTAGCTGG
AGCGAGACTGCTGCGCCAATGGAGGCCTAC|GCGGTAGCTGGAACGTCAAAGGGTTTTGGG
ACGGAAGATCGCGAAACAAAAGCATTGCAC|TCGTGCAGTGGTTCCAAGTATCACGGGCTC
AGAGTCTAAGGTCTTGGAGTCTAAGGTCTT|ATCAAGGACGCGTTTAAAGGCGCGCTTTTA
CGAAACACCTAAATTCCCAGACTCAGCGCT|ACGCAGAGAGTCTAAGGTCTTGTCACATTA
TGGTACAGAACAATTGTAAAACGCAAGACT|AACGCCCCAGGACCACAAAGAGCCCCTCGG
GTCTAAGGTCTTGATACACAAACGTTTTGG|CGCGAAACAAAAGCATTGCACGTTCTCGGG
ACAAACGTTTTGGGACGCAGAGAGTCTAAG|GCACGTTCTCGGGCCCGGTACCTCCAGTAA
TACCCTCCAGCCGAAATAGCTTACGGTTAA|TAGCGGCAGAGAGCCATAGGCGGAATATAA
TCACGGGCTCAGGGGCGAGGCCGAAGCGTG|GGTGCCGATTGTCGCTCAAGGCGTAGGGGT
TTCGTGCAGTGGTTCCAAGTATCACGGGCT|GTTAACACCGCTCAATGAAAAGGTGCCGAT
GGGACGCAGAGAGTCTAAGGTCTTGTTGAA|ATGATATTGGGCCTATACGCGGGCTTCAGT
TTTAGCTCCTGCGTTGGGTTTTGGGACGCA|GGGACGCAGAGAGTCTAAGGTCTTGTGTTT
ATAACATGCTACGTTTTGGGACGCAGAGAG|AAGGGTGATAGCTGGCCTGCAATTGAGGAC
CAAGCACGCGTGCAGGCACGGAAGATCGCG|GAAAGGACAAATAAATTTCGTGCAGTGGTT
GACGCAGAGAGTCTAAGGTCTTGGCCTATG|CGCAGAGAGTCTAAGGTCTTGGGGCGGCAC
ACAAAGCGAGCCAAAAGAGCGCAAAACCCT|CACAACGTGATGCGAACCAAAGGGGACTAG
GACGCAGAGAGTCTAAGGTCTTGTGTTTTG|TCTAAGGTCTTGATACACAAACGTTTTGGG
AGGCTCCGTCCGTTTTGGGACGCAGAGAGT|GTCAAGCACGCGTGCAGGCACGGAAGATCG
AATATACAACAAAGCGAGCCAAAAGAGCGC|GGGGTGTGCACAACGTGATGCGAACCAAAG
GTTTTGGGACGCAGAGAGTCTAAGGTCTTG|GCGCCAATGGAGGCCTACCCGTCAAGGCGC
CACAAGTGTGTTTTGGGACGCAGAGAGTCT|TGACGAAACACCTAAATTCCCAGACTCAGC
CAGTGGTTCCAAGTATCACGGGCTCAGGGG|ACCGCTCAATGAAAAGGTGCCGATTGTCGC
GCTCCGTCCGTTTTGGGACGCAGAGAGTCT|CAAGCACGCGTGCAGGCACGGAAGATCGCG
AAGGTTTTGGGACGCAGAGAGTCTAAGGTC|AGTCTAAGGTCTTGGAGTCTAAGGTCTTGG
GAGTCTAAGGTCTTGTGTTTTGGGACGCAG|CTTGATACACAAACGTTTTGGGACGCAGAG
ATAAATTTCGTGCAGTGGTTCCAAGTATCA|CTTACGGTTAACACCGCTCAATGAAAAGGT
GGACGCAGAGAGTCTAAGGTCTTGTCAAGC|ATTCCCAGACTCAGCGCTGCATGAGGAAAG
AACAACGGTTCTGTTGAGACTCACTTCGCA|GACGCAGAGAGTCTAAGGTCTTGCGCAGAG
CCTAGTCAGCCTGCAAACTACTCAGGCCAC|GTCTGTTTTGGGACGCAGAGAGTCTAAGGT
TTGGGACGCAGAGAGTCTAAGGTCTTGGGG|CGGGCCCGGTACCTCCAGTAAGTTTGAAAG
GCAGAGAGTCTAAGGTCTTGAAGGTCGTTT|ACGCAGAGAGTCTAAGGTCTTGGGACAGAG
GTTTTGGGACGCAGAGAGTCTAAGGTCTTG|TTTGGGACGCAGAGAGTCTAAGGTCTTGGG
GGTCTTGAAGGTCGTTTTGGGACGCAGAGA|AAGGTCTTGGGACAGAGAATGATATTGGGC
GCTGGAACGTCAAAGGGTTTTGGGACGCAG|GAGAGTCTAAGGTCTTGTCCCATTTGTCCC
CATTTGTCCCAGAAGATTAAGACAAATCAA|AGCGAGCCAAAAGAGCGCAAAACCCTGGTC
GAGACTCACTTCGCAACCTAGTCAGCCTGC|AGGTCTTGCGCAGAGAGTCTGTTTTGGGAC
CACTGGTTTTGGGAGTTTTGGGACGCAGAG|CTAGCGAGACTGCTGCGCCAATGGAGGCCT
CTAAGGTCTTGTTGAAACTCTAGCGAGACT|ATACGCGGGCTTCAGTTGCTGGCGGTAGCT
AGCACTGGTTTTGGGAGTTTTGGGACGCAG|CTCTAGCGAGACTGCTGCGCCAATGGAGGC
TGGTCATCAAAGTCTATACAAGTTTTGGGA|GGCTCCGTCCGTTTTGGGACGCAGAGAGTC
AGGTCTTGGGACAGAGAATGATATTGGGCC|CTTGGAACTTCTCTAAGATGGGGCAAGCGA
CCACGCGGTTATTCTCCAACGCCCCAGGAC|AGGTCTTGAAGGTCGTTTTGGGACGCAGAG
CGTGATGCGAACCAAAGGGGACTAGGCTCC|GGACGCAGAGAGTCTAAGGTCTTGTCAAGC
GGACGCAGAGAGTCTAAGGTCTTGTGTTTT|GTCTAAGGTCTTGATACACAAACGTTTTGG
GTCTTGATACACAAACGTTTTGGGACGCAG|CAAAAGCATTGCACGTTCTCGGGCCCGGTA
CAAGTGTGTTTTGGGACGCAGAGAGTCTAA|ACGAAACACCTAAATTCCCAGACTCAGCGC
TGTCCCATTTGTCCCAGAAGATTAAGACAA|AACAAAGCGAGCCAAAAGAGCGCAAAACCC
CAAAGGGGACTAGGCTCCGTCCGTTTTGGG|TCTAAGGTCTTGTCAAGCACGCGTGCAGGC
TTGACGAAACACCTAAATTCCCAGACTCAG|TGGGACGCAGAGAGTCTAAGGTCTTGTCAC
GCAAAGCACTGGTTTTGGGAGTTTTGGGAC|GAAACTCTAGCGAGACTGCTGCGCCAATGG
CCGTTTTGGGACGCAGAGAGTCTAAGGTCT|GCGTGCAGGCACGGAAGATCGCGAAACAAA
CACGTTCTCGGGCCCGGTACCTCCAGTAAG|CTCAGGGGCGAGGCCGAAGCGTGGTCTAGA
GAGTCTAAGGTCTTGATACACAAACGTTTT|ATCGCGAAACAAAAGCATTGCACGTTCTCG
GCCCTATACTAGGAAGGTTTTGGGACGCAG|TTGGGACGCAGAGAGTCTAAGGTCTTGGAG
GCAGAGTTTTGGGACGCAGAGAGTCTAAGG|TCCCAGAAGATTAAGACAAATCAAGGACGC
TATTGGGCCTATACGCGGGCTTCAGTTGCT|GGCAAGCGACTTAGCGAGTCTTCTGTTTTG
GAGTCTAAGGTCTTGGGGCGGCACTGCACA|CTCCAGTAAGTTTGAAAGACGCCACTTGAC
ACGCAGAGAGTCTAAGGTCTTGTCCCATTT|TGTCCGAACGTCAAATATACAACAAAGCGA
TTGCAAGTAGTGTCCGAACGTCAAATATAC|TCTAAGGTCTTGGCCTATGGCGTGGGGTGT
TTTGGGACGCAGAGAGTCTAAGGTCTTGTC|GCCTGCAATTGAGGACTGCTAGTATGGCTC
CAATTGTAAAACGCAAGACTGCACTGTAGA|GACCACAAAGAGCCCCTCGGCAAAGCACTG
CAAATATACAACAAAGCGAGCCAAAAGAGC|GTGGGGTGTGCACAACGTGATGCGAACCAA
GGTCTTGCAAGTAGTGTCCGAACGTCAAAT|AGAGTCTAAGGTCTTGGCCTATGGCGTGGG
AAGTATCACGGGCTCAGGGGCGAGGCCGAA|GAAAAGGTGCCGATTGTCGCTCAAGGCGTA
AGTCAGCCTGCAAACTACTCAGGCCACGCG|TGTTTTGGGACGCAGAGAGTCTAAGGTCTT
TTGATACACAAACGTTTTGGGACGCAGAGA|AAGCATTGCACGTTCTCGGGCCCGGTACCT
TCTAAGGTCTTGTTGAAACTCTAGCGAGAC|TATACGCGGGCTTCAGTTGCTGGCGGTAGC
CTTGGAGTCTAAGGTCTTGGAACTTCTCTA|TTTAAAGGCGCGCTTTTAGCTCCTGCGTTG
CAGGACCACAAAGAGCCCCTCGGCAAAGCA|GCAGAGAGTCTAAGGTCTTGTTGAAACTCT
CTCCTGCGTTGGGTTTTGGGACGCAGAGAG|GCAGAGAGTCTAAGGTCTTGTGTTTTGGGA
TCTAGATAACATGCTACGTTTTGGGACGCA|CATCGAAGGGTGATAGCTGGCCTGCAATTG
GGACGCAGAGAGTCTAAGGTCTTGGCCTAT|ACGCAGAGAGTCTAAGGTCTTGGGGCGGCA
CGCGGGCTTCAGTTGCTGGCGGTAGCTGGA|GCGAGTCTTCTGTTTTGGGACGCAGAGAGT
CAGAGAGTCTAAGGTCTTGATACACAAACG|GAAGATCGCGAAACAAAAGCATTGCACGTT
CAAAGTCTATACAAGTTTTGGGACGCAGAG|TCCGTTTTGGGACGCAGAGAGTCTAAGGTC
GAATGTAACAACGGTTCTGTTGAGACTCAC|TTTTGGGACGCAGAGAGTCTAAGGTCTTGC
GCCCCAGGACCACAAAGAGCCCCTCGGCAA|GGACGCAGAGAGTCTAAGGTCTTGTTGAAA
GGGCAAGCGACTTAGCGAGTCTTCTGTTTT|TGGGACGCAGAGAGTCTAAGGTCTTGCAAG
GGACGCAGAGAGTCTAAGGTCTTGTCCCAT|AGTGTCCGAACGTCAAATATACAACAAAGC
GCGAACCAAAGGGGACTAGGCTCCGTCCGT|AGAGAGTCTAAGGTCTTGTCAAGCACGCGT
TACGTTTTGGGACGCAGAGAGTCTAAGGTC|AGCTGGCCTGCAATTGAGGACTGCTAGTAT
GAAAGACGCCACTTGACGAAACACCTAAAT|CATGCTACGTTTTGGGACGCAGAGAGTCTA
TTCAGTTGCTGGCGGTAGCTGGAACGTCAA|TTCTGTTTTGGGACGCAGAGAGTCTAAGGT
AATTAGGAAACCCCGTGGACTTACTCCCCT|AAACTACTCAGGCCACGCGGTTATTCTCCA
CCAGAAGATTAAGACAAATCAAGGACGCGT|AAAAGAGCGCAAAACCCTGGTCATCAAAGT
TATACGCGGGCTTCAGTTGCTGGCGGTAGC|CTTAGCGAGTCTTCTGTTTTGGGACGCAGA
GTCTTCTGTTTTGGGACGCAGAGAGTCTAA|AGGTCTTGCAAGTAGTGTCCGAACGTCAAA
TCGTGCAGTGGTTCCAAGTATCACGGGCTC|TTAACACCGCTCAATGAAAAGGTGCCGATT
AAGCACTGGTTTTGGGAGTTTTGGGACGCA|ACTCTAGCGAGACTGCTGCGCCAATGGAGG
ACAAATAAATTTCGTGCAGTGGTTCCAAGT|ATAGCTTACGGTTAACACCGCTCAATGAAA
AGAGAGTCTGTTTTGGGACGCAGAGAGTCT|ATACTAGGAAGGTTTTGGGACGCAGAGAGT
ATTTGTCCCAGAAGATTAAGACAAATCAAG|GCGAGCCAAAAGAGCGCAAAACCCTGGTCA
GGTCTTGTCCCATTTGTCCCAGAAGATTAA|TATACAACAAAGCGAGCCAAAAGAGCGCAA
GGGACGCAGAGAGTCTAAGGTCTTGATACA|GGCACGGAAGATCGCGAAACAAAAGCATTG
AGAGGAATGTAACAACGGTTCTGTTGAGAC|GGAGTTTTGGGACGCAGAGAGTCTAAGGTC
CGTTTAAAGGCGCGCTTTTAGCTCCTGCGT|AGTCTATACAAGTTTTGGGACGCAGAGAGT
GGTGTGCACAACGTGATGCGAACCAAAGGG|AGTGTGTTTTGGGACGCAGAGAGTCTAAGG
GCTGCATGAGGAAAGGACAAATAAATTTCG|TTACCCTCCAGCCGAAATAGCTTACGGTTA
GTAGCTGGAACGTCAAAGGGTTTTGGGACG|GCAGAGAGTCTAAGGTCTTGTCCCATTTGT
CCGAAGCGTGGTCTAGATAACATGCTACGT|GCGTAGGGGTTCATCGAAGGGTGATAGCTG
AGGTCGTTTTGGGACGCAGAGAGTCTAAGG|GGGACAGAGAATGATATTGGGCCTATACGC
CAATGGAGGCCTACCCGTCAAGGCGCCCTA|CAAAGGGTTTTGGGACGCAGAGTTTTGGGA
TAGATGACTAAGAGGAATGTAACAACGGTT|ACTGGTTTTGGGAGTTTTGGGACGCAGAGA
GTCTTGTCACATTACCCTCCAGCCGAAATA|TATGGCTCATCATAGCGGCAGAGAGCCATA
AATTCCCAGACTCAGCGCTGCATGAGGAAA|CTAAGGTCTTGTCACATTACCCTCCAGCCG
CGCAGAGAGTCTAAGGTCTTGCAAGTAGTG|GTTTTGGGACGCAGAGAGTCTAAGGTCTTG
TCTTGGAGTCTAAGGTCTTGGAACTTCTCT|GTTTAAAGGCGCGCTTTTAGCTCCTGCGTT
GTTTTGGGACGCAGAGAGTCTAAGGTCTTG|TGGCCTGCAATTGAGGACTGCTAGTATGGC
TCCGTCCGTTTTGGGACGCAGAGAGTCTAA|AGCACGCGTGCAGGCACGGAAGATCGCGAA
AGTCTAAGGTCTTGTGTTTTGGGACGCAGA|TTGATACACAAACGTTTTGGGACGCAGAGA
TCTTGGCCTATGGCGTGGGGTGTGCACAAC|TTGGGGCGGCACTGCACAAGTGTGTTTTGG
GAAGGTCGTTTTGGGACGCAGAGAGTCTAA|TTGGGACAGAGAATGATATTGGGCCTATAC
AAGAGCGCAAAACCCTGGTCATCAAAGTCT|AACCAAAGGGGACTAGGCTCCGTCCGTTTT
GGACGCAGAGAGTCTAAGGTCTTGCAAGTA|TGTGTTTTGGGACGCAGAGAGTCTAAGGTC
TTTGGGACGCAGAGTTTTGGGACGCAGAGA|CCCATTTGTCCCAGAAGATTAAGACAAATC
TGGGACGCAGAGAGTCTAAGGTCTTGTCAC|CTGCAATTGAGGACTGCTAGTATGGCTCAT
GGGGCGGCACTGCACAAGTGTGTTTTGGGA|AAAGACGCCACTTGACGAAACACCTAAATT
TATTCTCCAACGCCCCAGGACCACAAAGAG|AGGTCGTTTTGGGACGCAGAGAGTCTAAGG
GGCGTGGGGTGTGCACAACGTGATGCGAAC|CTGCACAAGTGTGTTTTGGGACGCAGAGAG
CGTTGGGTTTTGGGACGCAGAGAGTCTAAG|AGTCTAAGGTCTTGTGTTTTGGGACGCAGA
AAGGTCTTGAAGGTCGTTTTGGGACGCAGA|CTAAGGTCTTGGGACAGAGAATGATATTGG
AGTTTTGGGACGCAGAGAGTCTAAGGTCTT|GCAGAGAGTCTAAGGTCTTGATACACAAAC
AAGGTCGTTTTGGGACGCAGAGAGTCTAAG|TGGGACAGAGAATGATATTGGGCCTATACG
TCCGTTTTGGGACGCAGAGAGTCTAAGGTC|CGCGTGCAGGCACGGAAGATCGCGAAACAA
CGCAAGACTGCACTGTAGATGACTAAGAGG|GCCCCTCGGCAAAGCACTGGTTTTGGGAGT
CCCGTCAAGGCGCCCTATACTAGGAAGGTT|GACGCAGAGTTTTGGGACGCAGAGAGTCTA
GACTCAGCGCTGCATGAGGAAAGGACAAAT|TTGTCACATTACCCTCCAGCCGAAATAGCT
CGCAGAGAGTCTGTTTTGGGACGCAGAGAG|CCTATACTAGGAAGGTTTTGGGACGCAGAG
ACCTCCAGTAAGTTTGAAAGACGCCACTTG|GCGTGGTCTAGATAACATGCTACGTTTTGG
TCAAGGCGCCCTATACTAGGAAGGTTTTGG|CAGAGTTTTGGGACGCAGAGAGTCTAAGGT
GGGACGCAGAGAGTCTAAGGTCTTGTGTTT|AGTCTAAGGTCTTGATACACAAACGTTTTG
AAATATACAACAAAGCGAGCCAAAAGAGCG|TGGGGTGTGCACAACGTGATGCGAACCAAA
TCAAAGTCTATACAAGTTTTGGGACGCAGA|GTCCGTTTTGGGACGCAGAGAGTCTAAGGT
AGGTCTTGTCAAGCACGCGTGCAGGCACGG|CTGCATGAGGAAAGGACAAATAAATTTCGT
TTGAAGGTCGTTTTGGGACGCAGAGAGTCT|TCTTGGGACAGAGAATGATATTGGGCCTAT
CAGAGAGTCTAAGGTCTTGCAAGTAGTGTC|TTTGGGACGCAGAGAGTCTAAGGTCTTGGC
TGGGACGCAGAGAGTCTAAGGTCTTGTTGA|AATGATATTGGGCCTATACGCGGGCTTCAG
CGAAGCGTGGTCTAGATAACATGCTACGTT|CGTAGGGGTTCATCGAAGGGTGATAGCTGG
ACTTCTCTAAGATGGGGCAAGCGACTTAGC|CCTGCGTTGGGTTTTGGGACGCAGAGAGTC
CGTCAAGGCGCCCTATACTAGGAAGGTTTT|CGCAGAGTTTTGGGACGCAGAGAGTCTAAG
GCAAGTAGTGTCCGAACGTCAAATATACAA|TAAGGTCTTGGCCTATGGCGTGGGGTGTGC
GGGAGTTTTGGGACGCAGAGAGTCTAAGGT|TGCTGCGCCAATGGAGGCCTACCCGTCAAG
TTTGGGACGCAGAGAGTCTAAGGTCTTGGC|TGGGACGCAGAGAGTCTAAGGTCTTGGGGC
CCAAAAGAGCGCAAAACCCTGGTCATCAAA|TGCGAACCAAAGGGGACTAGGCTCCGTCCG
TCTTGAAGGTCGTTTTGGGACGCAGAGAGT|GGTCTTGGGACAGAGAATGATATTGGGCCT
TTGGGACGCAGAGAGTCTAAGGTCTTGGGA|AGGTCTTGGAGTCTAAGGTCTTGGAACTTC
CAGTTGCTGGCGGTAGCTGGAACGTCAAAG|CTGTTTTGGGACGCAGAGAGTCTAAGGTCT
CCCCTCGGCAAAGCACTGGTTTTGGGAGTT|TCTTGTTGAAACTCTAGCGAGACTGCTGCG
CGGCACTGCACAAGTGTGTTTTGGGACGCA|ACGCCACTTGACGAAACACCTAAATTCCCA
TTGTCACATTACCCTCCAGCCGAAATAGCT|GGCTCATCATAGCGGCAGAGAGCCATAGGC
TGGGCCTATACGCGGGCTTCAGTTGCTGGC|AAGCGACTTAGCGAGTCTTCTGTTTTGGGA
CTATACTAGGAAGGTTTTGGGACGCAGAGA|GGACGCAGAGAGTCTAAGGTCTTGGAGTCT
ACTGCACAAGTGTGTTTTGGGACGCAGAGA|CACTTGACGAAACACCTAAATTCCCAGACT
AGGTCTTGTCACATTACCCTCCAGCCGAAA|AGTATGGCTCATCATAGCGGCAGAGAGCCA
AGTCTAAGGTCTTGGCCTATGGCGTGGGGT|TCTAAGGTCTTGGGGCGGCACTGCACAAGT
TTTTGGGACGCAGAGAGTCTAAGGTCTTGT|CAAGTAGTGTCCGAACGTCAAATATACAAC
GCCTATACGCGGGCTTCAGTTGCTGGCGGT|CGACTTAGCGAGTCTTCTGTTTTGGGACGC
ACGCCCCAGGACCACAAAGAGCCCCTCGGC|TGGGACGCAGAGAGTCTAAGGTCTTGTTGA
TTTTGGGACGCAGAGAGTCTAAGGTCTTGG|CTCGGGCCCGGTACCTCCAGTAAGTTTGAA
TTGGGACAGAGAATGATATTGGGCCTATAC|AACTTCTCTAAGATGGGGCAAGCGACTTAG
AGTAGTGTCCGAACGTCAAATATACAACAA|GGTCTTGGCCTATGGCGTGGGGTGTGCACA
CTAAGGTCTTGTCCCATTTGTCCCAGAAGA|CAAATATACAACAAAGCGAGCCAAAAGAGC
TTTAAAGGCGCGCTTTTAGCTCCTGCGTTG|TCTATACAAGTTTTGGGACGCAGAGAGTCT
TCTCTAAGATGGGGCAAGCGACTTAGCGAG|GCGTTGGGTTTTGGGACGCAGAGAGTCTAA
AACAATTGTAAAACGCAAGACTGCACTGTA|AGGACCACAAAGAGCCCCTCGGCAAAGCAC
TCTAAGGTCTTGTCAAGCACGCGTGCAGGC|AGCGCTGCATGAGGAAAGGACAAATAAATT
TTGGAACTTCTCTAAGATGGGGCAAGCGAC|TAGCTCCTGCGTTGGGTTTTGGGACGCAGA
TTGTCAAGCACGCGTGCAGGCACGGAAGAT|TGAGGAAAGGACAAATAAATTTCGTGCAGT
GAAGATTAAGACAAATCAAGGACGCGTTTA|AGAGCGCAAAACCCTGGTCATCAAAGTCTA
GCGCAAAACCCTGGTCATCAAAGTCTATAC|AAAGGGGACTAGGCTCCGTCCGTTTTGGGA
CTGTAGATGACTAAGAGGAATGTAACAACG|AGCACTGGTTTTGGGAGTTTTGGGACGCAG
GAAACACCTAAATTCCCAGACTCAGCGCTG|CGCAGAGAGTCTAAGGTCTTGTCACATTAC
TTGTTGAAACTCTAGCGAGACTGCTGCGCC|GCTTCAGTTGCTGGCGGTAGCTGGAACGTC
TGGGAGTTTTGGGACGCAGAGAGTCTAAGG|CTGCTGCGCCAATGGAGGCCTACCCGTCAA
CGGGCTCAGGGGCGAGGCCGAAGCGTGGTC|GCCGATTGTCGCTCAAGGCGTAGGGGTTCA
GCCTATGGCGTGGGGTGTGCACAACGTGAT|GCGGCACTGCACAAGTGTGTTTTGGGACGC
GGACAAATAAATTTCGTGCAGTGGTTCCAA|AAATAGCTTACGGTTAACACCGCTCAATGA
GCAGAGAGTCTAAGGTCTTGGGGCGGCACT|GGTACCTCCAGTAAGTTTGAAAGACGCCAC
GAGAATGATATTGGGCCTATACGCGGGCTT|TAAGATGGGGCAAGCGACTTAGCGAGTCTT
TATACAAGTTTTGGGACGCAGAGAGTCTAA|TGGGACGCAGAGAGTCTAAGGTCTTGATAC
TTTGGGACGCAGAGAGTCTAAGGTCTTGTC|AAGTAGTGTCCGAACGTCAAATATACAACA
TTCTCGGGCCCGGTACCTCCAGTAAGTTTG|GGGGCGAGGCCGAAGCGTGGTCTAGATAAC
CTAAGGTCTTGTGTTTTGGGACGCAGAGAG|ATACACAAACGTTTTGGGACGCAGAGAGTC
CTAAGGTCTTGATACACAAACGTTTTGGGA|CGAAACAAAAGCATTGCACGTTCTCGGGCC
AGACGCCACTTGACGAAACACCTAAATTCC|GCTACGTTTTGGGACGCAGAGAGTCTAAGG
ACTCTAGCGAGACTGCTGCGCCAATGGAGG|TGCTGGCGGTAGCTGGAACGTCAAAGGGTT
GTGGACTTACTCCCCTGGTACAGAACAATT|ACGCGGTTATTCTCCAACGCCCCAGGACCA
GTCTTGCGCAGAGAGTCTGTTTTGGGACGC|AGGCGCCCTATACTAGGAAGGTTTTGGGAC
CTAAGGTCTTGGAACTTCTCTAAGATGGGG|CGCGCTTTTAGCTCCTGCGTTGGGTTTTGG
CTAAGGTCTTGTCAAGCACGCGTGCAGGCA|GCGCTGCATGAGGAAAGGACAAATAAATTT
ACATGCTACGTTTTGGGACGCAGAGAGTCT|GGTGATAGCTGGCCTGCAATTGAGGACTGC
GACGCAGAGAGTCTAAGGTCTTGGGGCGGC|CCCGGTACCTCCAGTAAGTTTGAAAGACGC
AGAGAGTCTAAGGTCTTGCGCAGAGAGTCT|GCCTACCCGTCAAGGCGCCCTATACTAGGA
TTAGCGAGTCTTCTGTTTTGGGACGCAGAG|GAGTCTAAGGTCTTGCAAGTAGTGTCCGAA
TTGAAACTCTAGCGAGACTGCTGCGCCAAT|TCAGTTGCTGGCGGTAGCTGGAACGTCAAA
CAAGCGACTTAGCGAGTCTTCTGTTTTGGG|GACGCAGAGAGTCTAAGGTCTTGCAAGTAG
TGGGACGCAGAGAGTCTAAGGTCTTGGAGT|ATTAAGACAAATCAAGGACGCGTTTAAAGG
TTGCTGGCGGTAGCTGGAACGTCAAAGGGT|TTTTGGGACGCAGAGAGTCTAAGGTCTTGT
GCGGGCTTCAGTTGCTGGCGGTAGCTGGAA|CGAGTCTTCTGTTTTGGGACGCAGAGAGTC
AGGCCTACCCGTCAAGGCGCCCTATACTAG|GTTTTGGGACGCAGAGTTTTGGGACGCAGA
GTCTAAGGTCTTGGAACTTCTCTAAGATGG|GGCGCGCTTTTAGCTCCTGCGTTGGGTTTT
GGTCATCAAAGTCTATACAAGTTTTGGGAC|GCTCCGTCCGTTTTGGGACGCAGAGAGTCT
TTAAGACAAATCAAGGACGCGTTTAAAGGC|GCAAAACCCTGGTCATCAAAGTCTATACAA
GGCGAGGCCGAAGCGTGGTCTAGATAACAT|GCTCAAGGCGTAGGGGTTCATCGAAGGGTG
TTATTCTCCAACGCCCCAGGACCACAAAGA|AAGGTCGTTTTGGGACGCAGAGAGTCTAAG
GCGAGCCAAAAGAGCGCAAAACCCTGGTCA|CGTGATGCGAACCAAAGGGGACTAGGCTCC
GGGCGGCACTGCACAAGTGTGTTTTGGGAC|AAGACGCCACTTGACGAAACACCTAAATTC
AAGGTCTTGCAAGTAGTGTCCGAACGTCAA|AGAGAGTCTAAGGTCTTGGCCTATGGCGTG
TCTTGCAAGTAGTGTCCGAACGTCAAATAT|AGTCTAAGGTCTTGGCCTATGGCGTGGGGT
GGCTCAGGGGCGAGGCCGAAGCGTGGTCTA|CGATTGTCGCTCAAGGCGTAGGGGTTCATC
ATTAAGACAAATCAAGGACGCGTTTAAAGG|CGCAAAACCCTGGTCATCAAAGTCTATACA
TGATGCGAACCAAAGGGGACTAGGCTCCGT|ACGCAGAGAGTCTAAGGTCTTGTCAAGCAC
AGTCTAAGGTCTTGGAACTTCTCTAAGATG|AGGCGCGCTTTTAGCTCCTGCGTTGGGTTT
CAAAAGAGCGCAAAACCCTGGTCATCAAAG|GCGAACCAAAGGGGACTAGGCTCCGTCCGT
GGGTTTTGGGACGCAGAGAGTCTAAGGTCT|TAAGGTCTTGTGTTTTGGGACGCAGAGAGT
CACTTCGCAACCTAGTCAGCCTGCAAACTA|TGCGCAGAGAGTCTGTTTTGGGACGCAGAG
TGCTACGTTTTGGGACGCAGAGAGTCTAAG|GATAGCTGGCCTGCAATTGAGGACTGCTAG
AGTGGTTCCAAGTATCACGGGCTCAGGGGC|CCGCTCAATGAAAAGGTGCCGATTGTCGCT
AGAGAGTCTAAGGTCTTGGAGTCTAAGGTC|AAATCAAGGACGCGTTTAAAGGCGCGCTTT
GTCAAGCACGCGTGCAGGCACGGAAGATCG|AGGAAAGGACAAATAAATTTCGTGCAGTGG
CCGTCAAGGCGCCCTATACTAGGAAGGTTT|ACGCAGAGTTTTGGGACGCAGAGAGTCTAA
GGTCTTGTCAAGCACGCGTGCAGGCACGGA|TGCATGAGGAAAGGACAAATAAATTTCGTG
TGTCACATTACCCTCCAGCCGAAATAGCTT|GCTCATCATAGCGGCAGAGAGCCATAGGCG
TGCACTGTAGATGACTAAGAGGAATGTAAC|GCAAAGCACTGGTTTTGGGAGTTTTGGGAC
CCCGGTACCTCCAGTAAGTTTGAAAGACGC|GCCGAAGCGTGGTCTAGATAACATGCTACG
AAGGTCTTGGAACTTCTCTAAGATGGGGCA|CGCTTTTAGCTCCTGCGTTGGGTTTTGGGA
CGCTTTTAGCTCCTGCGTTGGGTTTTGGGA|TTTTGGGACGCAGAGAGTCTAAGGTCTTGT
AGTCTTCTGTTTTGGGACGCAGAGAGTCTA|AAGGTCTTGCAAGTAGTGTCCGAACGTCAA
CGTGGTCTAGATAACATGCTACGTTTTGGG|GGGTTCATCGAAGGGTGATAGCTGGCCTGC
ACAAAAGCATTGCACGTTCTCGGGCCCGGT|AAGTATCACGGGCTCAGGGGCGAGGCCGAA
TGACTAAGAGGAATGTAACAACGGTTCTGT|GTTTTGGGAGTTTTGGGACGCAGAGAGTCT
GTTTTGGGACGCAGAGAGTCTAAGGTCTTG|ACCTAAATTCCCAGACTCAGCGCTGCATGA
AAACACCTAAATTCCCAGACTCAGCGCTGC|GCAGAGAGTCTAAGGTCTTGTCACATTACC
AAGACGCCACTTGACGAAACACCTAAATTC|TGCTACGTTTTGGGACGCAGAGAGTCTAAG
TAGCGAGTCTTCTGTTTTGGGACGCAGAGA|AGTCTAAGGTCTTGCAAGTAGTGTCCGAAC
ACGCAGAGAGTCTAAGGTCTTGTTGAAACT|ATATTGGGCCTATACGCGGGCTTCAGTTGC
GTAGATGACTAAGAGGAATGTAACAACGGT|CACTGGTTTTGGGAGTTTTGGGACGCAGAG
ATGATATTGGGCCTATACGCGGGCTTCAGT|ATGGGGCAAGCGACTTAGCGAGTCTTCTGT
TTTTAGCTCCTGCGTTGGGTTTTGGGACGC|TGGGACGCAGAGAGTCTAAGGTCTTGTGTT
CCGGTACCTCCAGTAAGTTTGAAAGACGCC|CCGAAGCGTGGTCTAGATAACATGCTACGT
GTTTTGGGAGTTTTGGGACGCAGAGAGTCT|GAGACTGCTGCGCCAATGGAGGCCTACCCG
GAGTCTAAGGTCTTGGAACTTCTCTAAGAT|AAGGCGCGCTTTTAGCTCCTGCGTTGGGTT
AGAACAATTGTAAAACGCAAGACTGCACTG|CCAGGACCACAAAGAGCCCCTCGGCAAAGC
ATCGCGAAACAAAAGCATTGCACGTTCTCG|GTGGTTCCAAGTATCACGGGCTCAGGGGCG
AGAGTCTAAGGTCTTGTTGAAACTCTAGCG|GGCCTATACGCGGGCTTCAGTTGCTGGCGG
GGCCTATACGCGGGCTTCAGTTGCTGGCGG|GCGACTTAGCGAGTCTTCTGTTTTGGGACG
ACGCAGAGAGTCTAAGGTCTTGGGGCGGCA|CCGGTACCTCCAGTAAGTTTGAAAGACGCC
AGGTCTTGCGCAGAGAGTCTGTTTTGGGAC|CAAGGCGCCCTATACTAGGAAGGTTTTGGG
GGAGGCCTACCCGTCAAGGCGCCCTATACT|GGGTTTTGGGACGCAGAGTTTTGGGACGCA
GAGAGTCTAAGGTCTTGTGTTTTGGGACGC|GTCTTGATACACAAACGTTTTGGGACGCAG
GCTCAGGGGCGAGGCCGAAGCGTGGTCTAG|GATTGTCGCTCAAGGCGTAGGGGTTCATCG
GGTCTTGGAACTTCTCTAAGATGGGGCAAG|CTTTTAGCTCCTGCGTTGGGTTTTGGGACG
GTAGTGTCCGAACGTCAAATATACAACAAA|GTCTTGGCCTATGGCGTGGGGTGTGCACAA
TCTAAGGTCTTGTCCCATTTGTCCCAGAAG|TCAAATATACAACAAAGCGAGCCAAAAGAG
GTCTTGCAAGTAGTGTCCGAACGTCAAATA|GAGTCTAAGGTCTTGGCCTATGGCGTGGGG
ATGGCGTGGGGTGTGCACAACGTGATGCGA|CACTGCACAAGTGTGTTTTGGGACGCAGAG
TTGGGACGCAGAGAGTCTAAGGTCTTGTGT|AGAGTCTAAGGTCTTGATACACAAACGTTT
ACGCAGAGAGTCTAAGGTCTTGATACACAA|ACGGAAGATCGCGAAACAAAAGCATTGCAC
TCCTGCGTTGGGTTTTGGGACGCAGAGAGT|CAGAGAGTCTAAGGTCTTGTGTTTTGGGAC
GACTAGGCTCCGTCCGTTTTGGGACGCAGA|TCTTGTCAAGCACGCGTGCAGGCACGGAAG
TGTTTTGGGACGCAGAGAGTCTAAGGTCTT|AAGGTTTTGGGACGCAGAGAGTCTAAGGTC
CACTTGACGAAACACCTAAATTCCCAGACT|TTTTGGGACGCAGAGAGTCTAAGGTCTTGT
CAATTAGGAAACCCCGTGGACTTACTCCCC|CAAACTACTCAGGCCACGCGGTTATTCTCC
GTGTTTTGGGACGCAGAGAGTCTAAGGTCT|ACACCTAAATTCCCAGACTCAGCGCTGCAT
GTCCCAGAAGATTAAGACAAATCAAGGACG|GCCAAAAGAGCGCAAAACCCTGGTCATCAA
CAGAAGATTAAGACAAATCAAGGACGCGTT|AAAGAGCGCAAAACCCTGGTCATCAAAGTC
AAGGTCTTGCGCAGAGAGTCTGTTTTGGGA|TCAAGGCGCCCTATACTAGGAAGGTTTTGG
AGCATTGCACGTTCTCGGGCCCGGTACCTC|TCACGGGCTCAGGGGCGAGGCCGAAGCGTG
AGGTTTTGGGACGCAGAGAGTCTAAGGTCT|GTCTAAGGTCTTGGAGTCTAAGGTCTTGGA
AAGGTCTTGTCCCATTTGTCCCAGAAGATT|AATATACAACAAAGCGAGCCAAAAGAGCGC
GTAAGTTTGAAAGACGCCACTTGACGAAAC|CTAGATAACATGCTACGTTTTGGGACGCAG
TCTGTTTTGGGACGCAGAGAGTCTAAGGTC|GGAAGGTTTTGGGACGCAGAGAGTCTAAGG
GCACGCGTGCAGGCACGGAAGATCGCGAAA|AGGACAAATAAATTTCGTGCAGTGGTTCCA
CCGAACGTCAAATATACAACAAAGCGAGCC|CCTATGGCGTGGGGTGTGCACAACGTGATG
TTTTGGGACGCAGAGAGTCTAAGGTCTTGA|TGCAGGCACGGAAGATCGCGAAACAAAAGC
ACGTTCTCGGGCCCGGTACCTCCAGTAAGT|TCAGGGGCGAGGCCGAAGCGTGGTCTAGAT
CAGAGAGTCTAAGGTCTTGGGGCGGCACTG|GTACCTCCAGTAAGTTTGAAAGACGCCACT
CGTTCTCGGGCCCGGTACCTCCAGTAAGTT|CAGGGGCGAGGCCGAAGCGTGGTCTAGATA
TGGTCTAGATAACATGCTACGTTTTGGGAC|GTTCATCGAAGGGTGATAGCTGGCCTGCAA
GAGAGTCTAAGGTCTTGTCCCATTTGTCCC|GAACGTCAAATATACAACAAAGCGAGCCAA
CCCTCGGCAAAGCACTGGTTTTGGGAGTTT|CTTGTTGAAACTCTAGCGAGACTGCTGCGC
CTACTCAGGCCACGCGGTTATTCTCCAACG|GAGAGTCTAAGGTCTTGAAGGTCGTTTTGG
TCTAAGGTCTTGTCACATTACCCTCCAGCC|TGCTAGTATGGCTCATCATAGCGGCAGAGA
ACAGAACAATTGTAAAACGCAAGACTGCAC|CCCCAGGACCACAAAGAGCCCCTCGGCAAA
CAACAAAGCGAGCCAAAAGAGCGCAAAACC|TGCACAACGTGATGCGAACCAAAGGGGACT
GTCTTGTCCCATTTGTCCCAGAAGATTAAG|ATACAACAAAGCGAGCCAAAAGAGCGCAAA
AGAGTCTAAGGTCTTGTCACATTACCCTCC|GGACTGCTAGTATGGCTCATCATAGCGGCA
TGGGACGCAGAGAGTCTAAGGTCTTGGGAC|GGTCTTGGAGTCTAAGGTCTTGGAACTTCT
TTTGAAAGACGCCACTTGACGAAACACCTA|TAACATGCTACGTTTTGGGACGCAGAGAGT
GAGCCAAAAGAGCGCAAAACCCTGGTCATC|TGATGCGAACCAAAGGGGACTAGGCTCCGT
GGCGGCACTGCACAAGTGTGTTTTGGGACG|AGACGCCACTTGACGAAACACCTAAATTCC
CACAACGTGATGCGAACCAAAGGGGACTAG|TTTTGGGACGCAGAGAGTCTAAGGTCTTGT
CAACCTAGTCAGCCTGCAAACTACTCAGGC|AGAGTCTGTTTTGGGACGCAGAGAGTCTAA
GCAGAGAGTCTAAGGTCTTGGGACAGAGAA|GGAGTCTAAGGTCTTGGAACTTCTCTAAGA
TTGGGACGCAGAGAGTCTAAGGTCTTGTTG|GAATGATATTGGGCCTATACGCGGGCTTCA
GCAAGACTGCACTGTAGATGACTAAGAGGA|CCCCTCGGCAAAGCACTGGTTTTGGGAGTT
TCTAAGGTCTTGATACACAAACGTTTTGGG|GCGAAACAAAAGCATTGCACGTTCTCGGGC
GTGGGGTGTGCACAACGTGATGCGAACCAA|CACAAGTGTGTTTTGGGACGCAGAGAGTCT
GGGACGCAGAGAGTCTAAGGTCTTGGAGTC|TTAAGACAAATCAAGGACGCGTTTAAAGGC
GGACTAGGCTCCGTCCGTTTTGGGACGCAG|GTCTTGTCAAGCACGCGTGCAGGCACGGAA
CAGAGTTTTGGGACGCAGAGAGTCTAAGGT|CCCAGAAGATTAAGACAAATCAAGGACGCG
TGCAGGCACGGAAGATCGCGAAACAAAAGC|ATAAATTTCGTGCAGTGGTTCCAAGTATCA
ATGGGGCAAGCGACTTAGCGAGTCTTCTGT|TTTTGGGACGCAGAGAGTCTAAGGTCTTGC
TGCAAACTACTCAGGCCACGCGGTTATTCT|GACGCAGAGAGTCTAAGGTCTTGAAGGTCG
CAGGGGCGAGGCCGAAGCGTGGTCTAGATA|TGTCGCTCAAGGCGTAGGGGTTCATCGAAG
CGAGCCAAAAGAGCGCAAAACCCTGGTCAT|GTGATGCGAACCAAAGGGGACTAGGCTCCG
CTCAGGCCACGCGGTTATTCTCCAACGCCC|AGTCTAAGGTCTTGAAGGTCGTTTTGGGAC
CAAGTTTTGGGACGCAGAGAGTCTAAGGTC|ACGCAGAGAGTCTAAGGTCTTGATACACAA
CTGCATGAGGAAAGGACAAATAAATTTCGT|TACCCTCCAGCCGAAATAGCTTACGGTTAA
ACGCGGTTATTCTCCAACGCCCCAGGACCA|GTCTTGAAGGTCGTTTTGGGACGCAGAGAG
CTGTTTTGGGACGCAGAGAGTCTAAGGTCT|TTGCAAGTAGTGTCCGAACGTCAAATATAC
GCCACGCGGTTATTCTCCAACGCCCCAGGA|AAGGTCTTGAAGGTCGTTTTGGGACGCAGA
CAAAGCGAGCCAAAAGAGCGCAAAACCCTG|ACAACGTGATGCGAACCAAAGGGGACTAGG
TAAGGTCTTGGGACAGAGAATGATATTGGG|GTCTTGGAACTTCTCTAAGATGGGGCAAGC
CTCTAGCGAGACTGCTGCGCCAATGGAGGC|GCTGGCGGTAGCTGGAACGTCAAAGGGTTT
CTATGGCGTGGGGTGTGCACAACGTGATGC|GGCACTGCACAAGTGTGTTTTGGGACGCAG
TTGTCCCATTTGTCCCAGAAGATTAAGACA|CAACAAAGCGAGCCAAAAGAGCGCAAAACC
TGTTTTGGGACGCAGAGAGTCTAAGGTCTT|CACCTAAATTCCCAGACTCAGCGCTGCATG
AAGAGGAATGTAACAACGGTTCTGTTGAGA|GGGAGTTTTGGGACGCAGAGAGTCTAAGGT
ACTCAGGCCACGCGGTTATTCTCCAACGCC|GAGTCTAAGGTCTTGAAGGTCGTTTTGGGA
GCAGAGAGTCTAAGGTCTTGCGCAGAGAGT|AGGCCTACCCGTCAAGGCGCCCTATACTAG
ACACCTAAATTCCCAGACTCAGCGCTGCAT|AGAGAGTCTAAGGTCTTGTCACATTACCCT
AAGTGTGTTTTGGGACGCAGAGAGTCTAAG|CGAAACACCTAAATTCCCAGACTCAGCGCT
GAGCCCCTCGGCAAAGCACTGGTTTTGGGA|AGGTCTTGTTGAAACTCTAGCGAGACTGCT
AGGTCTTGCAAGTAGTGTCCGAACGTCAAA|GAGAGTCTAAGGTCTTGGCCTATGGCGTGG
TTGGGACGCAGAGAGTCTAAGGTCTTGTCA|TAAATTCCCAGACTCAGCGCTGCATGAGGA
CGGTACCTCCAGTAAGTTTGAAAGACGCCA|CGAAGCGTGGTCTAGATAACATGCTACGTT
CACGCGGTTATTCTCCAACGCCCCAGGACC|GGTCTTGAAGGTCGTTTTGGGACGCAGAGA
GAGAGTCTAAGGTCTTGATACACAAACGTT|AGATCGCGAAACAAAAGCATTGCACGTTCT
ACGCGTGCAGGCACGGAAGATCGCGAAACA|GACAAATAAATTTCGTGCAGTGGTTCCAAG
CTAGGAAGGTTTTGGGACGCAGAGAGTCTA|CAGAGAGTCTAAGGTCTTGGAGTCTAAGGT
GTTTGAAAGACGCCACTTGACGAAACACCT|ATAACATGCTACGTTTTGGGACGCAGAGAG
CTTCTGTTTTGGGACGCAGAGAGTCTAAGG|GTCTTGCAAGTAGTGTCCGAACGTCAAATA
CAAAGAGCCCCTCGGCAAAGCACTGGTTTT|TCTAAGGTCTTGTTGAAACTCTAGCGAGAC
GTCTTGAAGGTCGTTTTGGGACGCAGAGAG|AGGTCTTGGGACAGAGAATGATATTGGGCC
ATTCTCCAACGCCCCAGGACCACAAAGAGC|GGTCGTTTTGGGACGCAGAGAGTCTAAGGT
CCCAGACTCAGCGCTGCATGAGGAAAGGAC|GGTCTTGTCACATTACCCTCCAGCCGAAAT
CTAAGGTCTTGGGGCGGCACTGCACAAGTG|AGTAAGTTTGAAAGACGCCACTTGACGAAA
GCGAGTCTTCTGTTTTGGGACGCAGAGAGT|TCTAAGGTCTTGCAAGTAGTGTCCGAACGT
AGAATGATATTGGGCCTATACGCGGGCTTC|AAGATGGGGCAAGCGACTTAGCGAGTCTTC
AAACAAAAGCATTGCACGTTCTCGGGCCCG|CCAAGTATCACGGGCTCAGGGGCGAGGCCG
AGGTCTTGGAGTCTAAGGTCTTGGAACTTC|CGCGTTTAAAGGCGCGCTTTTAGCTCCTGC
CGCAGAGAGTCTAAGGTCTTGTCCCATTTG|GTCCGAACGTCAAATATACAACAAAGCGAG
AGTTGCTGGCGGTAGCTGGAACGTCAAAGG|TGTTTTGGGACGCAGAGAGTCTAAGGTCTT
TGGGGTGTGCACAACGTGATGCGAACCAAA|ACAAGTGTGTTTTGGGACGCAGAGAGTCTA
GAGCGCAAAACCCTGGTCATCAAAGTCTAT|CCAAAGGGGACTAGGCTCCGTCCGTTTTGG
GCACTGTAGATGACTAAGAGGAATGTAACA|CAAAGCACTGGTTTTGGGAGTTTTGGGACG
GCAGAGAGTCTAAGGTCTTGGCCTATGGCG|AGAGAGTCTAAGGTCTTGGGGCGGCACTGC
CGGTAGCTGGAACGTCAAAGGGTTTTGGGA|ACGCAGAGAGTCTAAGGTCTTGTCCCATTT
GCAGAGAGTCTAAGGTCTTGTCAAGCACGC|CCAGACTCAGCGCTGCATGAGGAAAGGACA
CACGCGTGCAGGCACGGAAGATCGCGAAAC|GGACAAATAAATTTCGTGCAGTGGTTCCAA
AATGTAACAACGGTTCTGTTGAGACTCACT|TTTGGGACGCAGAGAGTCTAAGGTCTTGCG
CGCAGAGAGTCTAAGGTCTTGGAGTCTAAG|GACAAATCAAGGACGCGTTTAAAGGCGCGC
GAGTCTAAGGTCTTGCAAGTAGTGTCCGAA|GGACGCAGAGAGTCTAAGGTCTTGGCCTAT
ATACGCGGGCTTCAGTTGCTGGCGGTAGCT|TTAGCGAGTCTTCTGTTTTGGGACGCAGAG
GTCTTGGAGTCTAAGGTCTTGGAACTTCTC|CGTTTAAAGGCGCGCTTTTAGCTCCTGCGT
GGCACTGCACAAGTGTGTTTTGGGACGCAG|CGCCACTTGACGAAACACCTAAATTCCCAG
GCAGAGAGTCTAAGGTCTTGATACACAAAC|GGAAGATCGCGAAACAAAAGCATTGCACGT
CGTTTTGGGACGCAGAGAGTCTAAGGTCTT|TTCTCGGGCCCGGTACCTCCAGTAAGTTTG
TTACCCTCCAGCCGAAATAGCTTACGGTTA|ATAGCGGCAGAGAGCCATAGGCGGAATATA
CAGCCTGCAAACTACTCAGGCCACGCGGTT|TTTGGGACGCAGAGAGTCTAAGGTCTTGAA
TAGCTCCTGCGTTGGGTTTTGGGACGCAGA|GACGCAGAGAGTCTAAGGTCTTGTGTTTTG
GTCTAAGGTCTTGGCCTATGGCGTGGGGTG|CTAAGGTCTTGGGGCGGCACTGCACAAGTG
GCAGAGAGTCTGTTTTGGGACGCAGAGAGT|CTATACTAGGAAGGTTTTGGGACGCAGAGA
AGTGTGTTTTGGGACGCAGAGAGTCTAAGG|GAAACACCTAAATTCCCAGACTCAGCGCTG
AAGCGACTTAGCGAGTCTTCTGTTTTGGGA|ACGCAGAGAGTCTAAGGTCTTGCAAGTAGT
CAGAGAGTCTGTTTTGGGACGCAGAGAGTC|TATACTAGGAAGGTTTTGGGACGCAGAGAG
GGAAACCCCGTGGACTTACTCCCCTGGTAC|ACTCAGGCCACGCGGTTATTCTCCAACGCC
GACAAATCAAGGACGCGTTTAAAGGCGCGC|AACCCTGGTCATCAAAGTCTATACAAGTTT
GAGTCTGTTTTGGGACGCAGAGAGTCTAAG|CTAGGAAGGTTTTGGGACGCAGAGAGTCTA
AGGTCTTGATACACAAACGTTTTGGGACGC|AACAAAAGCATTGCACGTTCTCGGGCCCGG
CGTGGGGTGTGCACAACGTGATGCGAACCA|GCACAAGTGTGTTTTGGGACGCAGAGAGTC
TTCCAAGTATCACGGGCTCAGGGGCGAGGC|CAATGAAAAGGTGCCGATTGTCGCTCAAGG
AGAGCCCCTCGGCAAAGCACTGGTTTTGGG|AAGGTCTTGTTGAAACTCTAGCGAGACTGC
AGAGTCTAAGGTCTTGGCCTATGGCGTGGG|AGTCTAAGGTCTTGGGGCGGCACTGCACAA
GTTTTGGGACGCAGAGTTTTGGGACGCAGA|GTCCCATTTGTCCCAGAAGATTAAGACAAA
TTGGGACGCAGAGAGTCTAAGGTCTTGCAA|TCTTGTGTTTTGGGACGCAGAGAGTCTAAG
TTGGGGCGGCACTGCACAAGTGTGTTTTGG|TGAAAGACGCCACTTGACGAAACACCTAAA
AGGAAGGTTTTGGGACGCAGAGAGTCTAAG|GAGAGTCTAAGGTCTTGGAGTCTAAGGTCT
ATACAACAAAGCGAGCCAAAAGAGCGCAAA|GTGTGCACAACGTGATGCGAACCAAAGGGG
AAGCACGCGTGCAGGCACGGAAGATCGCGA|AAAGGACAAATAAATTTCGTGCAGTGGTTC
GTCACATTACCCTCCAGCCGAAATAGCTTA|CTCATCATAGCGGCAGAGAGCCATAGGCGG
GATTAAGACAAATCAAGGACGCGTTTAAAG|GCGCAAAACCCTGGTCATCAAAGTCTATAC
GGTCTTGGGGCGGCACTGCACAAGTGTGTT|AGTTTGAAAGACGCCACTTGACGAAACACC
CGCCCCAGGACCACAAAGAGCCCCTCGGCA|GGGACGCAGAGAGTCTAAGGTCTTGTTGAA
TAAATTCCCAGACTCAGCGCTGCATGAGGA|GTCTAAGGTCTTGTCACATTACCCTCCAGC
TGGCGTGGGGTGTGCACAACGTGATGCGAA|ACTGCACAAGTGTGTTTTGGGACGCAGAGA
GTCTAAGGTCTTGTCAAGCACGCGTGCAGG|CAGCGCTGCATGAGGAAAGGACAAATAAAT
CAAATAAATTTCGTGCAGTGGTTCCAAGTA|TAGCTTACGGTTAACACCGCTCAATGAAAA
AAAAGAGCGCAAAACCCTGGTCATCAAAGT|CGAACCAAAGGGGACTAGGCTCCGTCCGTT
CGTTTTGGGACGCAGAGAGTCTAAGGTCTT|CAGAGAATGATATTGGGCCTATACGCGGGC
CCAACGCCCCAGGACCACAAAGAGCCCCTC|TTTTGGGACGCAGAGAGTCTAAGGTCTTGT
TAAGGTCTTGTCAAGCACGCGTGCAGGCAC|CGCTGCATGAGGAAAGGACAAATAAATTTC
TACCTCCAGTAAGTTTGAAAGACGCCACTT|AGCGTGGTCTAGATAACATGCTACGTTTTG
CGTGCAGGCACGGAAGATCGCGAAACAAAA|AAATAAATTTCGTGCAGTGGTTCCAAGTAT
GGACGCAGAGAGTCTAAGGTCTTGGGGCGG|GCCCGGTACCTCCAGTAAGTTTGAAAGACG
AGCACGCGTGCAGGCACGGAAGATCGCGAA|AAGGACAAATAAATTTCGTGCAGTGGTTCC
AAATAAATTTCGTGCAGTGGTTCCAAGTAT|AGCTTACGGTTAACACCGCTCAATGAAAAG
CCCAGGACCACAAAGAGCCCCTCGGCAAAG|ACGCAGAGAGTCTAAGGTCTTGTTGAAACT
TCTTGTCACATTACCCTCCAGCCGAAATAG|ATGGCTCATCATAGCGGCAGAGAGCCATAG
GTCAGCCTGCAAACTACTCAGGCCACGCGG|GTTTTGGGACGCAGAGAGTCTAAGGTCTTG
CAGAGAGTCTAAGGTCTTGCGCAGAGAGTC|GGCCTACCCGTCAAGGCGCCCTATACTAGG
GTTCCAAGTATCACGGGCTCAGGGGCGAGG|TCAATGAAAAGGTGCCGATTGTCGCTCAAG
ACGTTTTGGGACGCAGAGAGTCTAAGGTCT|GTTCTCGGGCCCGGTACCTCCAGTAAGTTT
TTGGGACGCAGAGAGTCTAAGGTCTTGCGC|CCAATGGAGGCCTACCCGTCAAGGCGCCCT
AGAGAGTCTAAGGTCTTGCAAGTAGTGTCC|TTGGGACGCAGAGAGTCTAAGGTCTTGGCC
CGCGAAACAAAAGCATTGCACGTTCTCGGG|GGTTCCAAGTATCACGGGCTCAGGGGCGAG
CTTGACGAAACACCTAAATTCCCAGACTCA|TTGGGACGCAGAGAGTCTAAGGTCTTGTCA
CAAAAGCATTGCACGTTCTCGGGCCCGGTA|AGTATCACGGGCTCAGGGGCGAGGCCGAAG
GGACGCAGAGAGTCTAAGGTCTTGGGACAG|TCTTGGAGTCTAAGGTCTTGGAACTTCTCT
CAGAGAGTCTAAGGTCTTGTTGAAACTCTA|TTGGGCCTATACGCGGGCTTCAGTTGCTGG
GGAACGTCAAAGGGTTTTGGGACGCAGAGT|AGTCTAAGGTCTTGTCCCATTTGTCCCAGA
TAGGAAGGTTTTGGGACGCAGAGAGTCTAA|AGAGAGTCTAAGGTCTTGGAGTCTAAGGTC
GCAAAACCCTGGTCATCAAAGTCTATACAA|AGGGGACTAGGCTCCGTCCGTTTTGGGACG
GAGAGTCTGTTTTGGGACGCAGAGAGTCTA|TACTAGGAAGGTTTTGGGACGCAGAGAGTC
GCGAGACTGCTGCGCCAATGGAGGCCTACC|CGGTAGCTGGAACGTCAAAGGGTTTTGGGA
GTCTTGGGGCGGCACTGCACAAGTGTGTTT|GTTTGAAAGACGCCACTTGACGAAACACCT
GCAGAGAGTCTAAGGTCTTGTGTTTTGGGA|AAGGTCTTGATACACAAACGTTTTGGGACG
GTCTTGGGACAGAGAATGATATTGGGCCTA|TGGAACTTCTCTAAGATGGGGCAAGCGACT
AGATTAAGACAAATCAAGGACGCGTTTAAA|AGCGCAAAACCCTGGTCATCAAAGTCTATA
ACGGGCTCAGGGGCGAGGCCGAAGCGTGGT|TGCCGATTGTCGCTCAAGGCGTAGGGGTTC
TTGAGACTCACTTCGCAACCTAGTCAGCCT|TAAGGTCTTGCGCAGAGAGTCTGTTTTGGG
GGCAAAGCACTGGTTTTGGGAGTTTTGGGA|TGAAACTCTAGCGAGACTGCTGCGCCAATG
GGGCTTCAGTTGCTGGCGGTAGCTGGAACG|AGTCTTCTGTTTTGGGACGCAGAGAGTCTA
AAGGACGCGTTTAAAGGCGCGCTTTTAGCT|TCATCAAAGTCTATACAAGTTTTGGGACGC
GTTTTGGGACGCAGAGAGTCTAAGGTCTTG|GAAGATTAAGACAAATCAAGGACGCGTTTA
GGCCTATGGCGTGGGGTGTGCACAACGTGA|GGCGGCACTGCACAAGTGTGTTTTGGGACG
TAAGGTCTTGGGGCGGCACTGCACAAGTGT|GTAAGTTTGAAAGACGCCACTTGACGAAAC
TGGGACGCAGAGAGTCTAAGGTCTTGTGTT|GAGTCTAAGGTCTTGATACACAAACGTTTT
AGAGAGTCTAAGGTCTTGATACACAAACGT|AAGATCGCGAAACAAAAGCATTGCACGTTC
ACGGTTCTGTTGAGACTCACTTCGCAACCT|CAGAGAGTCTAAGGTCTTGCGCAGAGAGTC
CAAGGCGCCCTATACTAGGAAGGTTTTGGG|AGAGTTTTGGGACGCAGAGAGTCTAAGGTC
TAAGGTCTTGTTGAAACTCTAGCGAGACTG|TACGCGGGCTTCAGTTGCTGGCGGTAGCTG
GAAGGTTTTGGGACGCAGAGAGTCTAAGGT|GAGTCTAAGGTCTTGGAGTCTAAGGTCTTG
